postId,posCommentCount,neuCommentCount,negCommentCount,totalCommentCount,netCompound
1991716644473195_1992773374367522,0,1,0,1,0
1991716644473195_1992774981034028,9,15,1,25,3.8622
1991716644473195_1992791511032375,1,0,0,1,0.5859
1991716644473195_1992805464364313,2,3,0,5,0.6572
1991716644473195_1995457094099150,1,3,1,5,0.3377
1991716644473195_1995524977425695,1,4,1,6,0.0222
1991716644473195_1995535297424663,0,2,0,2,0
1991716644473195_1996931270618399,8,4,0,12,3.5232
1991716644473195_1997093533935506,1,6,0,7,0.1027
1991716644473195_1997188833925976,1,0,0,1,0.5859
1991716644473195_1997422857235907,5,3,0,8,2.1228
1991716644473195_1997717560539770,5,6,0,11,3.4637
1991716644473195_1998098187168374,0,1,7,8,-3.189
1991716644473195_1998220037156189,2,3,0,5,0.8605
1991716644473195_1998718923772967,0,4,0,4,0
1991716644473195_1999038967074296,0,6,0,6,0
1991716644473195_1999065993738260,4,19,2,25,0.4505
1991716644473195_1999245653720294,6,4,0,10,2.7045
1991716644473195_1999609770350549,1,1,0,2,0.7845
1991716644473195_1999689580342568,0,1,0,1,0
1991716644473195_1999718663672993,1,1,0,2,0.3612
1991716644473195_2000121550299371,0,4,0,4,0
1991716644473195_2000796276898565,1,7,0,8,0.5204
1991716644473195_2000953706882822,0,9,3,12,-1.3703
1991716644473195_2002323966745796,5,8,0,13,2.0348
1991716644473195_2002383173406542,5,2,0,7,2.5176
1991716644473195_2002411570070369,2,4,1,7,0.6308
1991716644473195_2002455723399287,2,0,0,2,0.8808
1991716644473195_2002513993393460,21,4,0,25,10.7485
1991716644473195_2002594210052105,2,1,1,4,0.1985
1991716644473195_2002799223364937,1,8,2,11,-0.252
1991716644473195_2002800260031500,1,2,0,3,0.4404
1991716644473195_2002873670024159,0,2,0,2,0
1991716644473195_2002874170024109,1,0,0,1,0.4404
1991716644473195_2003083653336494,1,0,0,1,0.3818
1991716644473195_2003240639987462,6,4,2,12,1.3774
1991716644473195_2003353156642877,1,0,0,1,0.3612
1991716644473195_2003364013308458,0,3,2,5,-0.592
1991716644473195_2003370456641147,0,2,3,5,-0.888
1991716644473195_2003524656625727,4,20,1,25,1.4381
1991716644473195_2003526036625589,8,2,0,10,3.5673
1991716644473195_2003559833288876,9,0,1,10,3.9231
1991716644473195_2004532266524966,1,2,0,3,0.4927
1991716644473195_2004845253160334,1,0,0,1,0.0772
1991716644473195_2005178333127026,6,18,1,25,0.8455
1991716644473195_2005214389790087,1,22,2,25,0.3671
1991716644473195_2005230163121843,7,17,1,25,1.8909
1991716644473195_2005232513121608,2,8,1,11,0.4459
1991716644473195_2005236376454555,7,15,3,25,1.4559
1991716644473195_2005267253118134,3,21,1,25,0.5616
1991716644473195_2005274806450712,3,19,3,25,-0.3436
1991716644473195_2005291133115746,6,15,4,25,-0.9007
1991716644473195_2005294516448741,0,4,3,7,-1.0998
1991716644473195_2005475129764013,4,2,1,7,2.2949
1991716644473195_2005492406428952,7,17,1,25,2.5358
1991716644473195_2005512926426900,0,4,1,5,-0.2732
1991716644473195_2005614576416735,3,19,3,25,-0.4834
1991716644473195_2005688789742647,6,17,2,25,1.772
1991716644473195_2005699503074909,4,5,6,15,-1.4925
1991716644473195_2005702286407964,3,19,2,24,0.3363
1991716644473195_2005708559740670,0,2,0,2,0
1991716644473195_2005716296406563,0,6,0,6,0
1991716644473195_2005722476405945,0,3,0,3,0
1991716644473195_2005779829733543,1,11,0,12,0.3612
1991716644473195_2005785046399688,2,18,3,23,-0.6852
1991716644473195_2005813566396836,4,15,6,25,-1.6322
1991716644473195_2006304309681095,1,22,2,25,-0.7455
1991716644473195_2006374699674056,2,7,1,10,-0.2388
1991716644473195_2006379979673528,2,18,5,25,-1.7085
1991716644473195_2006380966340096,5,17,3,25,0.3909
1991716644473195_2006393389672187,1,5,1,7,-0.4947
1991716644473195_2006403183004541,1,6,0,7,0.34
1991716644473195_2006414329670093,1,3,0,4,0.4404
1991716644473195_2006420113002848,1,7,0,8,0.34
1991716644473195_2006424826335710,3,22,0,25,0.7136
1991716644473195_2006429513001908,0,1,1,2,-0.296
1991716644473195_2006431129668413,4,8,3,15,-0.2677
1991716644473195_2006543096323883,5,6,2,13,0.7543
1991716644473195_2006776502967209,0,1,0,1,0
1991716644473195_2006789422965917,7,10,8,25,-1.621
1991716644473195_2006793412965518,4,8,1,13,0.6681
1991716644473195_2006797502965109,4,11,5,20,-1.7545
1991716644473195_2006805506297642,2,2,1,5,-0.1421
1991716644473195_2006811552963704,4,20,1,25,0.7023
1991716644473195_2006812966296896,0,2,0,2,0
1991716644473195_2006833389628187,3,9,0,12,1.4725
1991716644473195_2006860546292138,8,6,2,16,3.2773
1991716644473195_2006863452958514,3,4,0,7,1.1806
1991716644473195_2006900662954793,8,12,4,24,1.5388
1991716644473195_2006931409618385,5,3,1,9,2.2512
1991716644473195_2006958042949055,0,2,0,2,0
1991716644473195_2007008732943986,1,0,0,1,0.4404
1991716644473195_2007029289608597,2,8,8,18,-3.4905
1991716644473195_2007041299607396,3,11,5,19,-1.1577
1991716644473195_2007047382940121,1,4,0,5,0.3182
1991716644473195_2007055102939349,5,7,2,14,0.7082
1991716644473195_2007058276272365,0,2,2,4,-0.6984
1991716644473195_2007395809571945,7,11,4,22,0.4527
1991716644473195_2007434719568054,7,8,1,16,2.5541
1991716644473195_2007515152893344,0,2,1,3,-0.6597
1991716644473195_2007517332893126,1,5,0,6,0.4404
1991716644473195_2007518196226373,1,0,0,1,0.4404
1991716644473195_2007529539558572,0,1,0,1,0
1991716644473195_2007546109556915,1,0,0,1,0.636
1991716644473195_2007548056223387,2,1,0,3,1.1689
1991716644473195_2007557299555796,5,4,0,9,2.0329
1991716644473195_2007557689555757,4,0,0,4,2.3774
1991716644473195_2007567422888117,9,5,0,14,5.0054
1991716644473195_2007585876219605,1,2,1,4,0.2624
1991716644473195_2007604312884428,1,0,0,1,0.636
1991716644473195_2007613026216890,1,2,0,3,0.0772
1991716644473195_2007734362871423,2,8,0,10,1.1399
1991716644473195_2007760362868823,0,6,0,6,0
1991716644473195_2007951029516423,3,3,0,6,1.1536
1991716644473195_2007975896180603,6,13,6,25,0.123
1991716644473195_2007977529513773,10,11,3,24,2.5993
1991716644473195_2007986512846208,1,0,0,1,0.636
1991716644473195_2008010259510500,2,3,1,6,0.6982
1991716644473195_2008016192843240,1,7,0,8,0.0772
1991716644473195_2008016329509893,0,4,0,4,0
1991716644473195_2008016392843220,5,8,0,13,1.699
1991716644473195_2008016512843208,4,17,3,24,0.1622
1991716644473195_2008017509509775,1,7,1,9,-0.168
1991716644473195_2008017636176429,3,19,3,25,-1.2426
1991716644473195_2008017729509753,0,2,0,2,0
1991716644473195_2008021842842675,1,3,2,6,-0.4451
1991716644473195_2008021909509335,0,4,0,4,0
1991716644473195_2008022036175989,3,3,0,6,0.7052
1991716644473195_2008022236175969,0,4,2,6,-1.0917
1991716644473195_2008022542842605,2,21,1,24,-0.1207
1991716644473195_2008022742842585,2,3,0,5,0.7956
1991716644473195_2008022902842569,0,0,1,1,-0.4098
1991716644473195_2008023789509147,0,1,0,1,0
1991716644473195_2008024342842425,1,0,0,1,0.2023
1991716644473195_2008024409509085,2,9,2,13,0.0345
1991716644473195_2008024519509074,0,4,0,4,0
1991716644473195_2008024829509043,0,4,0,4,0
1991716644473195_2008024932842366,1,3,0,4,0.4588
1991716644473195_2008025026175690,1,1,0,2,0.34
1991716644473195_2008025259509000,0,7,0,7,0
1991716644473195_2008028136175379,20,5,0,25,7.273
1991716644473195_2008028766175316,1,0,0,1,0.636
1991716644473195_2008047432840116,4,7,0,11,2.2814
1991716644473195_2008051396173053,1,0,0,1,0.636
1991716644473195_2008058966172296,1,0,0,1,0.636
1991716644473195_2008060892838770,1,0,0,1,0.636
1991716644473195_2008124889499037,1,0,0,1,0.636
1991716644473195_2008127349498791,1,2,0,3,0.636
1991716644473195_2008137022831157,1,0,0,1,0.636
1991716644473195_2008149529496573,1,14,0,15,0.34
1991716644473195_2008179106160282,1,1,0,2,0.636
1991716644473195_2008229182821941,3,1,0,4,1.4979
1991716644473195_2008263986151794,1,1,0,2,0.8074
1991716644473195_2008266369484889,6,5,1,12,2.7727
1991716644473195_2008420696136123,3,2,0,5,1.9322
1991716644473195_2008496299461896,1,3,0,4,0.4199
1991716644473195_2008499746128218,0,1,1,2,-0.5423
1991716644473195_2008508816127311,4,0,0,4,2.4342
1991716644473195_2008513499460176,5,1,2,8,1.8543
1991716644473195_2008517006126492,2,9,0,11,0.9292
1991716644473195_2008557849455741,2,8,0,10,1.3075
1991716644473195_2008582629453263,8,16,1,25,3.1964
1991716644473195_2008590009452525,1,0,0,1,0.4199
1991716644473195_2008612082783651,5,3,0,8,2.0468
1991716644473195_2008613102783549,12,11,2,25,3.0659
1991716644473195_2008614616116731,1,1,0,2,0.4466
1991716644473195_2008617076116485,1,1,0,2,0.636
1991716644473195_2008640806114112,1,3,0,4,0.6124
1991716644473195_2008646729446853,2,0,0,2,1.0764
1991716644473195_2008646969446829,3,1,0,4,1.6221
1991716644473195_2008650562779803,1,1,0,2,0.636
1991716644473195_2008655622779297,1,2,0,3,0.4939
1991716644473195_2008659386112254,14,4,0,18,8.1465
1991716644473195_2008664076111785,1,3,0,4,0.4404
1991716644473195_2008805029431023,0,9,0,9,0
1991716644473195_2008833952761464,1,0,0,1,0.5994
1991716644473195_2008886426089550,6,1,0,7,3.0666
1991716644473195_2009040392740820,1,1,0,2,0.636
1991716644473195_2009063002738559,1,1,0,2,0.1779
1991716644473195_2009076046070588,1,0,0,1,0.636
1991716644473195_2009111529400373,1,3,1,5,-0.4651
1991716644473195_2009132992731560,10,8,0,18,3.9314
1991716644473195_2009133059398220,1,1,0,2,0.8521
1991716644473195_2009137332731126,1,4,0,5,0.4404
1991716644473195_2009153956062797,0,1,0,1,0
1991716644473195_2009210396057153,0,3,0,3,0
1991716644473195_2009241939387332,1,1,0,2,0.2023
1991716644473195_2009247142720145,8,11,3,22,2.5823
1991716644473195_2009266972718162,0,1,0,1,0
1991716644473195_2009313416046851,1,0,0,1,0.636
1991716644473195_2009351139376412,2,3,0,5,0.9466
1991716644473195_2009397102705149,0,7,0,7,0
1991716644473195_2009403646037828,0,3,0,3,0
1991716644473195_2009557272689132,1,3,0,4,0.2023
1991716644473195_2009607526017440,2,0,0,2,0.7498
1991716644473195_2009621999349326,2,0,0,2,1.1627
1991716644473195_2009641959347330,3,6,0,9,1.272
1991716644473195_2009643676013825,1,5,1,7,-0.1019
1991716644473195_2009643949347131,7,7,0,14,3.1412
1991716644473195_2009656339345892,3,4,0,7,1.8073
1991716644473195_2009714329340093,1,0,0,1,0.636
1991716644473195_2009720202672839,1,2,0,3,0.636
1991716644473195_2009770666001126,5,4,0,9,2.9609
1991716644473195_2009773979334128,1,0,0,1,0.636
1991716644473195_2009821885996004,2,0,0,2,1.1627
1991716644473195_2009822229329303,1,0,0,1,0.636
1991716644473195_2009824179329108,0,3,0,3,0
1991716644473195_2009825852662274,1,9,1,11,0.2141
1991716644473195_2009840809327445,0,1,0,1,0
1991716644473195_2009860012658858,2,0,0,2,1.2354
1991716644473195_2009872945990898,1,1,0,2,0.636
1991716644473195_2009877259323800,0,3,0,3,0
1991716644473195_2009961179315408,1,4,0,5,0.3612
1991716644473195_2009976345980558,0,1,0,1,0
1991716644473195_2010088679302658,2,6,0,8,0.976
1991716644473195_2010137172631142,3,2,1,6,0.5875
1991716644473195_2010139925964200,1,1,0,2,0.4215
1991716644473195_2010159599295566,2,0,0,2,1.2354
1991716644473195_2010173532627506,3,8,1,12,0.2712
1991716644473195_2010173969294129,4,2,0,6,2.1496
1991716644473195_2010195249292001,0,4,1,5,-0.5106
1991716644473195_2010197065958486,3,6,0,9,1.0102
1991716644473195_2010238412621018,7,3,0,10,3.8093
1991716644473195_2010239825954210,3,4,0,7,1.6758
1991716644473195_2010261795952013,4,6,0,10,2.5338
1991716644473195_2010262199285306,2,1,0,3,1.3048
1991716644473195_2010272529284273,2,3,0,5,1.0575
1991716644473195_2010315945946598,2,0,0,2,1.2354
1991716644473195_2010375502607309,1,0,0,1,0.636
1991716644473195_2010409215937271,5,2,0,7,2.9703
1991716644473195_2010426579268868,3,2,0,5,1.2487
1991716644473195_2010441219267404,1,0,0,1,0.636
1991716644473195_2010461485932044,2,3,0,5,0.7548
1991716644473195_2010474562597403,3,0,0,3,1.8348
1991716644473195_2010481805930012,2,1,0,3,1.2354
1991716644473195_2010609772583882,0,3,1,4,-0.5267
1991716644473195_2010645959246930,0,3,0,3,0
1991716644473195_2010679675910225,1,2,0,3,0.636
1991716644473195_2010686469242879,0,1,1,2,-0.2263
1991716644473195_2010735435904649,1,0,0,1,0.4404
1991716644473195_2010739309237595,2,3,0,5,0.7527
1991716644473195_2010741099237416,2,0,0,2,1.1287
1991716644473195_2010760905902102,1,0,0,1,0.636
1991716644473195_2010793072565552,3,16,6,25,-0.9932
1991716644473195_2010813292563530,1,0,0,1,0.636
1991716644473195_2010947082550151,7,4,1,12,2.5005
1991716644473195_2010956669215859,2,2,0,4,0.7132
1991716644473195_2011035852541274,4,2,0,6,2.4342
1991716644473195_2011266925851500,2,1,0,3,1.1627
1991716644473195_2011283985849794,1,0,0,1,0.636
1991716644473195_2011284989183027,1,0,0,1,0.636
1991716644473195_2011292765848916,1,1,0,2,0.636
1991716644473195_2011346915843501,2,0,0,2,0.8623
1991716644473195_2011355145842678,1,2,0,3,0.6369
1991716644473195_2011739959137530,1,0,0,1,0.636
1991716644473195_2011763135801879,1,2,0,3,0.636
1991716644473195_2011767619134764,3,15,7,25,-1.3884
1991716644473195_2011808992463960,1,2,0,3,0.4404
1991716644473195_2011812145796978,0,3,0,3,0
1991716644473195_2011820595796133,1,0,0,1,0.636
1991716644473195_2011839049127621,3,3,0,6,1.5249
1991716644473195_2011844025793790,3,1,0,4,1.8348
1991716644473195_2011873785790814,5,1,0,6,3.2518
1991716644473195_2011875659123960,10,0,0,10,5.1306
1991716644473195_2011876005790592,4,1,0,5,2.2025
1991716644473195_2012021035776089,4,0,0,4,2.4342
1991716644473195_2012024032442456,1,0,0,1,0.636
1991716644473195_2012332942411565,4,3,0,7,2.3615
1991716644473195_2012362572408602,4,1,0,5,2.2025
1991716644473195_2012376369073889,5,0,0,5,3.0336
1991716644473195_2012401435738049,0,0,1,1,-0.6174
1991716644473195_2012446532400206,1,0,0,1,0.636
1991716644473195_2012459812398878,1,0,0,1,0.636
1991716644473195_2012460079065518,1,0,0,1,0.636
1991716644473195_2012468855731307,4,0,1,5,0.9708
1991716644473195_2012489312395928,0,2,0,2,0
1991716644473195_2012548202390039,1,1,0,2,0.636
1991716644473195_2012551459056380,3,0,0,3,1.8348
1991716644473195_2012585522386307,2,1,0,3,0.976
1991716644473195_2012742142370645,7,2,0,9,3.5586
1991716644473195_2012761345702058,3,1,0,4,1.6886
1991716644473195_2012770132367846,0,3,0,3,0
1991716644473195_2012770409034485,1,0,2,3,-0.3805
1991716644473195_2012773815700811,1,0,0,1,0.636
1991716644473195_2012786755699517,1,0,0,1,0.636
1991716644473195_2012814379030088,2,0,0,2,1.4631
1991716644473195_2012820479029478,1,0,0,1,0.636
1991716644473195_2012821559029370,2,0,0,2,1.0575
1991716644473195_2012823409029185,3,0,0,3,1.5842
1991716644473195_2012841975693995,3,0,0,3,1.6374
1991716644473195_2012849842359875,1,0,0,1,0.636
1991716644473195_2012853635692829,1,0,0,1,0.636
1991716644473195_2012863942358465,1,1,0,2,0.5994
1991716644473195_2012891395689053,4,6,0,10,1.3946
1991716644473195_2012939842350875,4,5,0,9,1.3717
1991716644473195_2012984139013112,2,0,0,2,1.2354
1991716644473195_2012985609012965,2,0,0,2,1.2354
1991716644473195_2012996602345199,1,0,0,1,0.636
1991716644473195_2013021925676000,1,0,0,1,0.636
1991716644473195_2013025332342326,1,1,0,2,0.296
1991716644473195_2013056432339216,6,1,0,7,2.6455
1991716644473195_2013103655667827,1,0,0,1,0.636
1991716644473195_2013115365666656,1,1,0,2,0.636
1991716644473195_2013135452331314,3,1,0,4,1.5168
1991716644473195_2013172398994286,1,0,0,1,0.636
1991716644473195_2013173142327545,1,0,0,1,0.636
1991716644473195_2013179348993591,3,2,0,5,1.6758
1991716644473195_2013331438978382,1,0,0,1,0.636
1991716644473195_2013401328971393,0,2,0,2,0
1991716644473195_2013414498970076,3,2,0,5,1.7086
1991716644473195_2013448235633369,2,0,0,2,1.2354
1991716644473195_2013455012299358,1,2,0,3,0.3818
1991716644473195_2013484402296419,4,0,0,4,2.4708
1991716644473195_2013490912295768,3,5,1,9,0.0115
1991716644473195_2013491458962380,2,7,0,9,0.3732
1991716644473195_2013529352291924,3,0,0,3,2.0503
1991716644473195_2013532218958304,3,0,0,3,1.7987
1991716644473195_2013556945622498,2,0,0,2,1.1627
1991716644473195_2013564082288451,1,0,0,1,0.636
1991716644473195_2013605812284278,1,0,0,1,0.636
1991716644473195_2013656525612540,7,5,0,12,3.9942
1991716644473195_2013686412276218,1,0,0,1,0.636
1991716644473195_2013696375608555,4,1,1,6,1.6758
1991716644473195_2013699118941614,3,0,0,3,1.6758
1991716644473195_2013866925591500,2,0,0,2,1.1627
1991716644473195_2013875218924004,6,3,1,10,2.9605
1991716644473195_2013929152251944,4,0,0,4,2.2752
1991716644473195_2013957308915795,4,0,0,4,2.2025
1991716644473195_2013972778914248,1,2,0,3,0.2263
1991716644473195_2013977558913770,1,2,0,3,0.636
1991716644473195_2013982472246612,2,0,0,2,0.9972
1991716644473195_2013987035579489,1,1,0,2,0.4199
1991716644473195_2013992435578949,1,0,0,1,0.636
1991716644473195_2013995858911940,4,0,0,4,1.8073
1991716644473195_2014016735576519,3,0,0,3,1.7346
1991716644473195_2014049188906607,1,0,0,1,0.636
1991716644473195_2014122278899298,0,1,0,1,0
1991716644473195_2014132248898301,1,0,0,1,0.636
1991716644473195_2014180172226842,1,0,0,1,0.636
1991716644473195_2014208915557301,2,0,0,2,1.1627
1991716644473195_2014215638889962,2,0,0,2,1.2354
1991716644473195_2014328085545384,2,0,0,2,1.0379
1991716644473195_2014419865536206,1,0,0,1,0.636
1991716644473195_2014427692202090,3,0,0,3,1.6031
1991716644473195_2014437308867795,6,0,0,6,3.9359
1991716644473195_2014469815531211,3,0,0,3,1.7982
1991716644473195_2014491438862382,2,0,0,2,1.1627
1991716644473195_2014505092194350,0,5,0,5,0
1991716644473195_2014507972194062,1,2,0,3,0.5994
1991716644473195_2014511395527053,5,7,0,12,2.7981
1991716644473195_2014517452193114,5,4,0,9,2.6488
1991716644473195_2014517545526438,3,0,0,3,1.6031
1991716644473195_2014518312193028,0,2,0,2,0
1991716644473195_2014525385525654,0,5,0,5,0
1991716644473195_2014674522177407,2,0,0,2,1.0764
1991716644473195_2014860512158808,3,1,0,4,1.6569
1991716644473195_2014968475481345,3,0,0,3,2.0029
1991716644473195_2014983338813192,1,0,0,1,0.4199
1991716644473195_2014988908812635,2,0,0,2,1.2846
1991716644473195_2015045212140338,1,0,0,1,0.636
1991716644473195_2015052182139641,2,1,0,3,1.0764
1991716644473195_2015056108805915,2,1,0,3,0.6468
1991716644473195_2015057315472461,2,0,0,2,1.2354
1991716644473195_2015085832136276,1,12,0,13,0.2023
1991716644473195_2015107422134117,4,0,0,4,2.6156
1991716644473195_2015107568800769,4,0,0,4,2.2391
1991716644473195_2015109128800613,2,0,0,2,1.1627
1991716644473195_2015109638800562,3,1,0,4,1.7621
1991716644473195_2015119842132875,2,1,0,3,1.0764
1991716644473195_2015130242131835,1,3,0,4,0.3612
1991716644473195_2015137475464445,2,1,0,3,1.1627
1991716644473195_2015207085457484,2,1,0,3,1.2354
1991716644473195_2015493485428844,1,0,0,1,0.636
1991716644473195_2015522615425931,1,0,0,1,0.636
1991716644473195_2015630488748477,1,0,0,1,0.636
1991716644473195_2015649662079893,2,0,1,3,0.636
1991716644473195_2015684855409707,2,0,0,2,1.1627
1991716644473195_2015709762073883,3,2,0,5,1.6684
1991716644473195_2015742978737228,2,0,0,2,0.9781
1991716644473195_2015800372064822,1,0,0,1,0.636
1991716644473195_2015820382062821,4,6,0,10,2.228
1991716644473195_2015831878728338,0,1,0,1,0
1991716644473195_2016135175364675,3,5,0,8,1.9962
1991716644473195_2016212602023599,2,1,0,3,1.1627
1991716644473195_2016222618689264,1,1,0,2,0.4215
1991716644473195_2016248472020012,2,0,0,2,1.1627
1991716644473195_2016266955351497,3,0,0,3,1.6942
1991716644473195_2016267192018140,0,1,1,2,-0.296
1991716644473195_2016298025348390,5,1,0,6,2.7227
1991716644473195_2016325618678964,3,1,0,4,1.5842
1991716644473195_2016360785342114,5,2,0,7,3.2701
1991716644473195_2016373628674163,0,4,0,4,0
1991716644473195_2016418472003012,4,0,0,4,2.0973
1991716644473195_2016451421999717,3,0,0,3,2.0137
1991716644473195_2016496905328502,5,5,1,11,1.6887
1991716644473195_2016504278661098,4,0,0,4,2.3814
1991716644473195_2016512688660257,4,2,0,6,1.6944
1991716644473195_2016552218656304,1,17,0,18,0.4466
1991716644473195_2016553291989530,0,1,1,2,-0.296
1991716644473195_2016565818654944,0,0,1,1,-0.6808
1991716644473195_2016743608637165,1,6,0,7,0.0772
1991716644473195_2016759518635574,2,2,0,4,0.9972
1991716644473195_2016778328633693,2,5,0,7,0.6582
1991716644473195_2016785695299623,4,0,0,4,2.1233
1991716644473195_2016794558632070,1,6,0,7,0.3182
1991716644473195_2016804018631124,8,3,0,11,4.5601
1991716644473195_2016831605295032,2,2,0,4,0.7364
1991716644473195_2016835451961314,1,0,0,1,0.636
1991716644473195_2016872431957616,1,0,0,1,0.636
1991716644473195_2016903621954497,0,1,0,1,0
1991716644473195_2016931785285014,1,0,0,1,0.636
1991716644473195_2016944751950384,1,0,0,1,0.636
1991716644473195_2017101238601402,1,0,0,1,0.636
1991716644473195_2017101965267996,3,2,0,5,1.5168
1991716644473195_2017105681934291,2,4,0,6,0.6979
1991716644473195_2017347661910093,2,5,0,7,1.1627
1991716644473195_2017445485233644,0,3,1,4,-0.5423
1991716644473195_2017573891887470,0,2,0,2,0
1991716644473195_2017744875203705,4,1,0,5,2.4659
1991716644473195_2017967348514791,1,1,0,2,0.5719
1991716644473195_2018038601840999,4,13,8,25,-0.2553
1991716644473195_2018045905173602,1,0,0,1,0.296
1991716644473195_2018144705163722,6,19,0,25,1.4527
1991716644473195_2018158501829009,1,5,3,9,-0.1846
1991716644473195_2018160641828795,1,2,1,4,-0.2287
1991716644473195_2018168845161308,2,5,3,10,-0.4444
1991716644473195_2018184298493096,7,18,0,25,2.9063
1991716644473195_2018185665159626,0,3,0,3,0
1991716644473195_2018187411826118,1,7,0,8,0.296
1991716644473195_2018194298492096,0,0,1,1,-0.296
1991716644473195_2018206511824208,2,3,0,5,0.6979
1991716644473195_2018208641823995,1,0,1,2,0
1991716644473195_2018213351823524,2,1,0,3,0.7804
1991716644473195_2018231325155060,0,2,1,3,-0.296
1991716644473195_2018266775151515,1,1,0,2,0.6369
1991716644473195_2018289871815872,1,1,0,2,0.9403
1991716644473195_2018292285148964,0,5,1,6,-0.296
1991716644473195_2018307165147476,0,0,1,1,-0.296
1991716644473195_2018573768454149,4,2,0,6,2.3797
1991716644473195_2018651831779676,0,2,0,2,0
1991716644473195_2018671991777660,5,11,3,19,0.9911
1991716644473195_2018672551777604,0,3,2,5,-0.7504
1991716644473195_2018712265106966,0,3,1,4,-0.296
1991716644473195_2018735771771282,4,13,2,19,0.9701
1991716644473195_2018767441768115,0,3,0,3,0
1991716644473195_2018798621764997,4,17,2,23,-0.0358
1991716644473195_2018805771764282,1,1,0,2,0.3612
1991716644473195_2018819605096232,1,14,1,16,-0.2307
1991716644473195_2018833521761507,2,1,2,5,0.1485
1991716644473195_2018881911756668,0,1,0,1,0
1991716644473195_2018884448423081,1,1,0,2,0.4404
1991716644473195_2018923845085808,2,3,0,5,0.7586
1991716644473195_2018946175083575,0,1,0,1,0
1991716644473195_2018973065080886,2,2,0,4,0.4384
1991716644473195_2019011288410397,2,1,1,4,0.4248
1991716644473195_2019041705074022,0,1,0,1,0
1991716644473195_2019055238406002,0,1,1,2,-0.5106
1991716644473195_2019067548404771,0,1,1,2,-0.296
1991716644473195_2019316148379911,2,3,1,6,0.6032
1991716644473195_2019328061712053,4,2,0,6,2.4529
1991716644473195_2019335025044690,0,1,0,1,0
1991716644473195_2019347005043492,3,2,2,7,0.4542
1991716644473195_2019400178371508,2,1,2,5,-0.0698
1991716644473195_2019439278367598,1,1,0,2,0.636
1991716644473195_2019508191694040,2,0,0,2,0.7811
1991716644473195_2019508631693996,3,1,0,4,1.5966
1991716644473195_2019518131693046,0,1,0,1,0
1991716644473195_2019547061690153,1,1,0,2,0.5859
1991716644473195_2019557185022474,3,21,1,25,0.4669
1991716644473195_2019595201685339,1,6,1,8,0.3034
1991716644473195_2019599765018216,3,2,0,5,1.3172
1991716644473195_2020288451616014,0,0,1,1,-0.296
1991716644473195_2020290028282523,1,8,2,11,-0.3277
1991716644473195_2020297628281763,0,4,0,4,0
1991716644473195_2020337031611156,1,6,2,9,-0.1516
1991716644473195_2020371318274394,2,0,0,2,1.1988
1991716644473195_2020380918273434,0,5,2,7,-0.8506
1991716644473195_2020435044934688,1,1,1,3,-0.3247
1991716644473195_2020486851596174,0,1,0,1,0
1991716644473195_2020532711591588,0,1,0,1,0
1991716644473195_2020545814923611,3,17,5,25,-0.548
1991716644473195_2020579138253612,0,5,0,5,0
1991716644473195_2020604814917711,1,7,0,8,0.0772
1991716644473195_2020608401584019,2,8,1,11,0.4034
1991716644473195_2020679104910282,1,14,2,17,-0.5148
1991716644473195_2020826051562254,3,1,0,4,1.264
1991716644473195_2020952798216246,0,1,0,1,0
1991716644473195_2020984031546456,1,3,0,4,0.5106
1991716644473195_2021014891543370,0,1,0,1,0
1991716644473195_2021017734876419,0,1,1,2,-0.5994
1991716644473195_2021023081542551,5,10,1,16,1.7328
1991716644473195_2021052584872934,1,4,0,5,0.5859
1991716644473195_2021092468202279,2,6,1,9,0.1334
1991716644473195_2021093071535552,1,4,0,5,0.4466
1991716644473195_2021285474849645,0,2,0,2,0
1991716644473195_2021307868180739,1,4,0,5,0.3818
1991716644473195_2021341761510683,0,3,0,3,0
1991716644473195_2021350098176516,2,2,0,4,0.7364
1991716644473195_2021362568175269,1,2,0,3,0.4404
1991716644473195_2021449424833250,9,13,0,22,4.6988
1991716644473195_2021488191496040,4,3,0,7,1.1153
1991716644473195_2021552898156236,9,8,1,18,3.2825
1991716644473195_2021600044818188,0,5,0,5,0
1991716644473195_2021843591460500,0,2,1,3,-0.6249
1991716644473195_2021845498126976,1,3,0,4,0.296
1991716644473195_2021914714786721,0,1,1,2,-0.296
1991716644473195_2021923124785880,0,1,0,1,0
1991716644473195_2021967841448075,0,6,0,6,0
1991716644473195_2022017351443124,2,12,2,16,-0.0897
1991716644473195_2022018638109662,1,0,1,2,0.092
1991716644473195_2022195728091953,0,1,0,1,0
1991716644473195_2022202748091251,1,4,2,7,-1.0208
1991716644473195_2022209711423888,3,5,0,8,1.2926
1991716644473195_2022425148069011,0,4,3,7,-0.8006
1991716644473195_2022710538040472,0,1,0,1,0
1991716644473195_2022711934706999,1,0,0,1,0.4939
1991716644473195_2022755448035981,1,3,1,5,-0.0619
1991716644473195_2022820581362801,0,1,0,1,0
1991716644473195_2022888524689340,3,2,0,5,1.6554
1991716644473195_2022977891347070,0,3,0,3,0
1991716644473195_2023053928006133,1,9,2,12,-0.0859
1991716644473195_2023061738005352,1,0,0,1,0.34
1991716644473195_2023064938005032,4,10,3,17,0.2318
1991716644473195_2023178271327032,1,0,0,1,0.636
1991716644473195_2023249841319875,0,2,0,2,0
1991716644473195_2023561154622077,1,2,0,3,0.6249
1991716644473195_2023595074618685,2,2,0,4,0.8718
1991716644473195_2023651437946382,4,12,3,19,0.4835
1991716644473195_2023706761274183,9,1,0,10,5.1634
1991716644473195_2023762084601984,3,4,0,7,1.1536
1991716644473195_2023816627929863,1,0,0,1,0.636
1991716644473195_2023843207927205,6,8,3,17,0.4093
1991716644473195_2023866074591585,0,1,0,1,0
1991716644473195_2023953971249462,1,2,0,3,0.4404
1991716644473195_2023964764581716,0,2,0,2,0
1991716644473195_2023969607914565,3,10,2,15,0.3161
1991716644473195_2023985074579685,0,5,0,5,0
1991716644473195_2024083731236486,1,10,0,11,0.6249
1991716644473195_2024093154568877,5,1,0,6,2.9609
1991716644473195_2024183181226541,1,4,0,5,0.6369
1991716644473195_2024189964559196,1,0,0,1,0.4019
1991716644473195_2024221944555998,6,8,0,14,2.409
1991716644473195_2024301727881353,1,3,0,4,0.6369
1991716644473195_2024598271185032,2,3,1,6,0.4622
1991716644473195_2024639414514251,7,4,1,12,3.3863
1991716644473195_2024659984512194,0,2,0,2,0
1991716644473195_2024660954512097,1,1,0,2,0.4588
1991716644473195_2024799047831621,3,0,0,3,1.7621
1991716644473195_2024833621161497,0,7,2,9,-0.9891
1991716644473195_2024915901153269,0,2,0,2,0
1991716644473195_2024933281151531,2,1,1,4,0.3937
1991716644473195_2025029344475258,1,0,0,1,0.636
1991716644473195_2025077437803782,0,2,0,2,0
1991716644473195_2025208594457333,1,2,0,3,0.636
1991716644473195_2025607814417411,0,1,1,2,-0.296
1991716644473195_2025897257721800,2,7,0,9,0.7548
1991716644473195_2025942634383929,1,1,0,2,0.0258
1991716644473195_2025942824383910,1,1,0,2,0.0258
1991716644473195_2025982741046585,1,4,0,5,0.296
1991716644473195_2026098901034969,0,2,0,2,0
1991716644473195_2026273421017517,0,2,0,2,0
1991716644473195_2026279551016904,1,4,0,5,0.296
1991716644473195_2026286357682890,0,1,0,1,0
1991716644473195_2026289364349256,0,1,0,1,0
1991716644473195_2026294467682079,0,1,0,1,0
1991716644473195_2026325121012347,0,1,0,1,0
1991716644473195_2026706017640924,0,3,0,3,0
1991716644473195_2026798467631679,2,3,3,8,-0.227
1991716644473195_2026878754290317,0,1,0,1,0
1991716644473195_2026958984282294,0,1,0,1,0
1991716644473195_2026965774281615,4,0,0,4,1.6461
1991716644473195_2026970440947815,0,2,1,3,-0.4767
1991716644473195_2026995334278659,1,4,0,5,0.0772
1991716644473195_2026999180944941,1,1,0,2,0.5379
1991716644473195_2027058697605656,0,2,0,2,0
1991716644473195_2027062427605283,5,2,3,10,0.137
1991716644473195_2027069257604600,1,1,0,2,0.34
1991716644473195_2027093614268831,2,7,0,9,0.4172
1991716644473195_2027096717601854,0,9,0,9,0
1991716644473195_2027202600924599,2,1,0,3,0.6755
1991716644473195_2027210804257112,1,0,0,1,0.636
1991716644473195_2027211444257048,2,0,0,2,1.0764
1991716644473195_2027213720923487,1,0,0,1,0.636
1991716644473195_2027228004255392,0,1,0,1,0
1991716644473195_2027230590921800,1,2,0,3,0.34
1991716644473195_2027333620911497,7,1,0,8,3.7554
1991716644473195_2027806484197544,0,1,0,1,0
1991716644473195_2027849357526590,2,5,0,7,0.6117
1991716644473195_2027886080856251,1,1,0,2,0.34
1991716644473195_2027898420855017,1,1,0,2,0.5719
1991716644473195_2027920287519497,0,4,0,4,0
1991716644473195_2027935814184611,1,0,0,1,0.7783
1991716644473195_2028004534177739,0,1,0,1,0
1991716644473195_2028017137509812,0,1,0,1,0
1991716644473195_2028051410839718,1,1,1,3,0.1444
1991716644473195_2028118454166347,1,3,0,4,0.6249
1991716644473195_2028121660832693,3,0,0,3,1.1022
1991716644473195_2028327817478744,1,4,3,8,-0.461
1991716644473195_2028396677471858,2,1,0,3,0.103
1991716644473195_2028399654138227,1,0,0,1,0.0258
1991716644473195_2028897230755136,1,0,0,1,0.636
1991716644473195_2028949647416561,1,0,0,1,0.0258
1991716644473195_2028950804083112,1,2,0,3,0.0258
1991716644473195_2028950820749777,9,9,7,25,2.5986
1991716644473195_2028954184082774,2,5,1,8,0.2023
1991716644473195_2029048244073368,2,0,0,2,0.3658
1991716644473195_2029058410739018,1,3,0,4,0.34
1991716644473195_2029088420736017,1,0,0,1,0.0772
1991716644473195_2029302187381307,1,3,0,4,0.636
1991716644473195_2029307490714110,2,0,0,2,1.0764
1991716644473195_2029310754047117,2,1,0,3,0.4277
1991716644473195_2029775214000671,1,0,0,1,0.0258
1991716644473195_2029780534000139,0,1,1,2,-0.296
1991716644473195_2029781137333412,1,2,0,3,0.0258
1991716644473195_2029782567333269,1,0,0,1,0.7783
1991716644473195_2029786793999513,1,0,0,1,0.0258
1991716644473195_2029858667325659,0,1,1,2,-0.5267
1991716644473195_2029871047324421,2,5,0,7,0.6582
1991716644473195_2029883707323155,2,4,0,6,0.592
1991716644473195_2029891383989054,0,2,0,2,0
1991716644473195_2029895393988653,0,2,1,3,-0.296
1991716644473195_2029947753983417,3,8,0,11,0.9502
1991716644473195_2029970783981114,1,1,0,2,0.296
1991716644473195_2030177007293825,1,1,0,2,0.3612
1991716644473195_2030181363960056,0,4,0,4,0
1991716644473195_2030257407285785,0,1,0,1,0
1991716644473195_2030264583951734,0,1,1,2,-0.296
1991716644473195_2030273357284190,3,2,0,5,0.9754
1991716644473195_2030275167284009,1,1,0,2,0.4404
1991716644473195_2030286000616259,0,2,0,2,0
1991716644473195_2030759587235567,5,9,1,15,2.2057
1991716644473195_2030787227232803,7,15,3,25,1.7648
1991716644473195_2030810347230491,0,6,0,6,0
1991716644473195_2030906613887531,0,2,0,2,0
1991716644473195_2030946273883565,1,3,0,4,0.0772
1991716644473195_2030950267216499,2,1,0,3,1.2354
1991716644473195_2031012863876906,0,5,0,5,0
1991716644473195_2031070277204498,0,2,0,2,0
1991716644473195_2031093507202175,1,3,1,5,0.0218
1991716644473195_2031286123849580,2,2,0,4,0.7419
1991716644473195_2031320307179495,1,0,1,2,0.2532
1991716644473195_2031365190508340,0,4,0,4,0
1991716644473195_2031706097140916,1,1,0,2,0.636
1991716644473195_2031856050459254,0,4,0,4,0
1991716644473195_2031879120456947,1,5,0,6,0.296
1991716644473195_2032016690443190,0,3,0,3,0
1991716644473195_2032019870442872,0,6,2,8,-0.6979
1991716644473195_2032068147104711,2,0,0,2,1.2354
1991716644473195_2032107187100807,2,13,0,15,0.8066
1991716644473195_2032190117092514,0,1,0,1,0
1991716644473195_2032192687092257,0,1,0,1,0
1991716644473195_2032199530424906,1,6,0,7,0.34
1991716644473195_2032218543756338,0,1,0,1,0
1991716644473195_2032224810422378,0,5,0,5,0
1991716644473195_2032238433754349,1,2,2,5,-0.0387
1991716644473195_2032285483749644,0,1,0,1,0
1991716644473195_2032299643748228,2,2,0,4,1.2354
1991716644473195_2032363707075155,5,2,1,8,2.5918
1991716644473195_2032676887043837,1,2,0,3,0.4019
1991716644473195_2032726223705570,4,11,0,15,2.2933
1991716644473195_2032777670367092,0,2,0,2,0
1991716644473195_2032779560366903,3,7,1,11,1.6042
1991716644473195_2032786267032899,1,3,0,4,0.6369
1991716644473195_2032787400366119,0,4,1,5,-0.296
1991716644473195_2032798437031682,0,2,0,2,0
1991716644473195_2032849643693228,1,1,0,2,0.0258
1991716644473195_2032870840357775,0,2,0,2,0
1991716644473195_2032884813689711,3,7,2,12,0.163
1991716644473195_2033043077007218,2,5,0,7,0.7132
1991716644473195_2033049580339901,5,6,6,17,-0.3492
1991716644473195_2033087237002802,2,10,2,14,0.2751
1991716644473195_2033167523661440,5,7,1,13,1.36
1991716644473195_2033242523653940,0,1,0,1,0
1991716644473195_2033612363616956,0,1,0,1,0
1991716644473195_2034115473566645,0,3,0,3,0
1991716644473195_2034570626854463,2,12,2,16,-0.2188
1991716644473195_2034575563520636,0,10,1,11,-0.296
1991716644473195_2034607293517463,0,3,0,3,0
1991716644473195_2034645710180288,1,5,0,6,0.4404
1991716644473195_2034656806845845,8,6,4,18,2.9781
1991716644473195_2034714120173447,11,12,2,25,5.5426
1991716644473195_2034720463506146,1,1,0,2,0.7184
1991716644473195_2034786950166164,2,7,3,12,-0.4184
1991716644473195_2034801283498064,3,9,0,12,1.4864
1991716644473195_2034806336830892,10,13,2,25,2.3509
1991716644473195_2034827126828813,1,0,1,2,0.4224
1991716644473195_2034854260159433,6,5,0,11,3.1205
1991716644473195_2034954580149401,4,1,0,5,1.387
1991716644473195_2035042920140567,2,1,0,3,0.1544
1991716644473195_2035053786806147,1,6,1,8,0.1761
1991716644473195_2035081190136740,3,3,0,6,1.9172
1991716644473195_2035163303461862,4,1,0,5,1.2032
1991716644473195_2035630253415167,0,2,0,2,0
1991716644473195_2035651380079721,2,2,0,4,1.0268
1991716644473195_2036531516658374,1,4,3,8,-0.8896
1991716644473195_2036546916656834,1,0,0,1,0.636
1991716644473195_2036547713323421,5,3,0,8,2.9769
1991716644473195_2036657023312490,0,8,0,8,0
1991716644473195_2036743666637159,18,7,0,25,8.2937
1991716644473195_2036768156634710,13,10,2,25,6.0986
1991716644473195_2036795349965324,2,1,0,3,1.3178
1991716644473195_2036815293296663,0,4,0,4,0
1991716644473195_2036817489963110,1,3,1,5,0.1794
1991716644473195_2036825389962320,1,0,0,1,0.7184
1991716644473195_2036833836628142,1,0,0,1,0.7506
1991716644473195_2036888833289309,1,0,0,1,0.7184
1991716644473195_2036906659954193,2,4,1,7,0.6383
1991716644473195_2036945109950348,2,0,1,3,0.5428
1991716644473195_2036947526616773,7,2,0,9,3.7583
1991716644473195_2036947849950074,6,1,0,7,3.3182
1991716644473195_2036983873279805,2,1,0,3,0.4662
1991716644473195_2037085733269619,3,1,0,4,1.9172
1991716644473195_2037085843269608,1,0,1,2,0.1628
1991716644473195_2037147486596777,4,10,2,16,1.2263
1991716644473195_2037183063259886,2,1,1,4,1.0218
1991716644473195_2037206283257564,3,2,0,5,1.4205
1991716644473195_2037219689922890,2,1,1,4,0.6821
1991716644473195_2037495943228598,1,2,0,3,0.0258
1991716644473195_2037599583218234,0,0,1,1,-0.2263
1991716644473195_2037631863215006,0,2,0,2,0
1991716644473195_2037634626548063,1,0,0,1,0.7184
1991716644473195_2037640213214171,1,0,0,1,0.7184
1991716644473195_2037677353210457,1,1,0,2,0.0258
1991716644473195_2037833746528151,1,1,0,2,0.5994
1991716644473195_2037838233194369,1,0,0,1,0.5994
1991716644473195_2037841826527343,4,19,2,25,1.2447
1991716644473195_2037886469856212,3,1,0,4,1.5136
1991716644473195_2037938626517663,2,1,0,3,1.1988
1991716644473195_2037960169848842,2,5,1,8,0.4426
1991716644473195_2037980466513479,3,1,0,4,1.5476
1991716644473195_2038078216503704,2,0,0,2,1.1988
1991716644473195_2038091809835678,1,1,0,2,0.5994
1991716644473195_2038142439830615,2,2,0,4,0.9671
1991716644473195_2038637636447762,0,1,0,1,0
1991716644473195_2038649919779867,3,2,2,7,0.6722
1991716644473195_2038650286446497,0,4,0,4,0
1991716644473195_2038698203108372,1,0,0,1,0.0258
1991716644473195_2038713749773484,16,6,3,25,9.0014
1991716644473195_2038728909771968,1,2,0,3,0.4019
1991716644473195_2038787256432800,1,0,0,1,0.5994
1991716644473195_2038799513098241,1,2,0,3,0.296
1991716644473195_2038890529755806,1,5,3,9,-0.4887
1991716644473195_2038929596418566,4,5,1,10,1.6917
1991716644473195_2039036019741257,16,2,1,19,7.8527
1991716644473195_2039104316401094,0,3,0,3,0
1991716644473195_2039118236399702,1,6,0,7,0.296
1991716644473195_2039230009721858,2,0,0,2,1.0398
1991716644473195_2039235453054647,0,4,0,4,0
1991716644473195_2039247873053405,4,3,0,7,1.6767
1991716644473195_2039614476350078,4,14,2,20,1.2402
1991716644473195_2039617029683156,0,7,0,7,0
1991716644473195_2039656966345829,2,9,2,13,0.2113
1991716644473195_2039683436343182,23,2,0,25,12.0561
1991716644473195_2039706849674174,3,3,0,6,1.6188
1991716644473195_2039854636326062,7,5,0,12,3.2519
1991716644473195_2039881279656731,2,2,1,5,0.0452
1991716644473195_2039889799655879,2,8,1,11,0.375
1991716644473195_2039909546320571,2,1,0,3,1.5448
1991716644473195_2039923622985830,0,2,3,5,-0.888
1991716644473195_2039948489650010,4,17,4,25,-0.0603
1991716644473195_2039967176314808,1,0,0,1,0.5994
1991716644473195_2040076982970494,2,0,0,2,1.5307
1991716644473195_2040081439636715,2,0,0,2,0.9606
1991716644473195_2040118579633001,0,3,0,3,0
1991716644473195_2040156209629238,19,6,0,25,8.8353
1991716644473195_2040171689627690,2,5,2,9,-0.1242
1991716644473195_2040180622960130,2,5,2,9,0.4292
1991716644473195_2040188376292688,0,3,1,4,-0.4019
1991716644473195_2040229716288554,1,0,1,2,0.0954
1991716644473195_2040245126287013,4,2,1,7,1.6827
1991716644473195_2040255079619351,1,0,0,1,0.5994
1991716644473195_2040310136280512,1,0,0,1,0.5994
1991716644473195_2040632249581634,0,1,0,1,0
1991716644473195_2040714449573414,0,5,0,5,0
1991716644473195_2040759136235612,4,5,0,9,2.3652
1991716644473195_2040782326233293,2,1,2,5,0.1979
1991716644473195_2040794559565403,1,7,2,10,-0.1789
1991716644473195_2040824839562375,2,7,1,10,0.6098
1991716644473195_2040826046228921,0,1,0,1,0
1991716644473195_2040826066228919,3,2,0,5,1.7982
1991716644473195_2040828476228678,2,1,2,5,-0.4162
1991716644473195_2040839289560930,3,3,3,9,-0.3945
1991716644473195_2040878242890368,0,4,0,4,0
1991716644473195_2040887529556106,2,2,0,4,0.7899
1991716644473195_2040894282888764,4,4,0,8,2.434
1991716644473195_2040906779554181,5,0,0,5,2.9835
1991716644473195_2040971209547738,1,0,1,2,-0.0548
1991716644473195_2041061689538690,3,0,0,3,1.5518
1991716644473195_2041076939537165,17,3,0,20,9.04
1991716644473195_2041103076201218,1,2,0,3,0.636
1991716644473195_2041110862867106,0,1,2,3,-0.7224
1991716644473195_2041150846196441,19,0,0,19,10.0223
1991716644473195_2041297229515136,12,1,0,13,6.0233
1991716644473195_2041327219512137,0,4,2,6,-0.6572
1991716644473195_2041348969509962,2,1,0,3,0.7364
1991716644473195_2041368979507961,2,3,0,5,0.7477
1991716644473195_2041685419476317,3,1,0,4,1.5966
1991716644473195_2041809392797253,1,5,0,6,0.3818
1991716644473195_2041940676117458,0,4,1,5,-0.296
1991716644473195_2041964226115103,2,4,1,7,0.1308
1991716644473195_2041993536112172,2,11,2,15,-0.0209
1991716644473195_2042004466111079,22,3,0,25,10.4495
1991716644473195_2042029849441874,5,0,0,5,2.7803
1991716644473195_2042053046106221,3,21,1,25,1.1676
1991716644473195_2042053559439503,1,2,0,3,0.5994
1991716644473195_2042055299439329,2,3,1,6,0.4061
1991716644473195_2042056359439223,2,4,0,6,1.481
1991716644473195_2042067909438068,14,2,0,16,7.492
1991716644473195_2042075679437291,1,1,1,3,0
1991716644473195_2042210922757100,2,4,2,8,0.1553
1991716644473195_2042222646089261,5,0,0,5,2.4467
1991716644473195_2042223442755848,2,0,0,2,1.2354
1991716644473195_2042252736086252,4,8,1,13,1.7543
1991716644473195_2042300669414792,4,0,0,4,1.9017
1991716644473195_2042699539374905,14,8,0,22,7.0848
1991716644473195_2042850962693096,4,2,0,6,2.1051
1991716644473195_2042885002689692,0,6,1,7,-0.296
1991716644473195_2043016342676558,0,4,0,4,0
1991716644473195_2043057146005811,2,0,0,2,1.11
1991716644473195_2043105752667617,0,3,1,4,-0.3612
1991716644473195_2043149369329922,2,0,0,2,1.0209
1991716644473195_2043217375989788,2,0,0,2,1.0209
1991716644473195_2043269582651234,9,1,0,10,4.2658
1991716644473195_2043749535936572,0,2,0,2,0
1991716644473195_2043755149269344,6,1,0,7,2.797
1991716644473195_2043824819262377,2,7,0,9,1.0212
1991716644473195_2043898305921695,5,0,0,5,2.9604
1991716644473195_2043936322584560,1,0,0,1,0.636
1991716644473195_2043965255915000,1,3,0,4,0.3612
1991716644473195_2043990822579110,5,0,0,5,2.3232
1991716644473195_2044030692575123,8,4,0,12,3.3302
1991716644473195_2044091349235724,7,0,0,7,3.938
1991716644473195_2044129029231956,1,0,0,1,0.636
1991716644473195_2044130139231845,0,2,2,4,-0.6979
1991716644473195_2044149935896532,2,0,0,2,1.35
1991716644473195_2044198479225011,1,2,0,3,0.4404
1991716644473195_2044232109221648,1,1,0,2,0.6249
1991716644473195_2044250432553149,1,2,1,4,0.184
1991716644473195_2044323149212544,10,3,0,13,4.3825
1991716644473195_2044326035878922,2,0,0,2,1.2243
1991716644473195_2044327265878799,0,2,0,2,0
1991716644473195_2044388182539374,1,0,0,1,0.5994
1991716644473195_2044391185872407,5,0,0,5,2.7379
1991716644473195_2044643522513840,1,0,0,1,0.5994
1991716644473195_2044751659169693,1,0,0,1,0.5994
1991716644473195_2044762309168628,2,10,0,12,0.8339
1991716644473195_2044782255833300,0,2,0,2,0
1991716644473195_2044786852499507,4,7,0,11,1.5583
1991716644473195_2044793039165555,1,1,0,2,0.0772
1991716644473195_2044808285830697,16,3,0,19,7.5629
1991716644473195_2044808442497348,4,15,6,25,-0.0217
1991716644473195_2044815022496690,2,0,0,2,1.7327
1991716644473195_2044830849161774,0,1,0,1,0
1991716644473195_2044841625827363,0,2,0,2,0
1991716644473195_2044918632486329,1,3,0,4,0.296
1991716644473195_2044926499152209,1,10,0,11,0.296
1991716644473195_2044945012483691,8,4,0,12,3.7061
1991716644473195_2044958559149003,8,1,0,9,4.2503
1991716644473195_2045007162477476,1,6,2,9,-0.5655
1991716644473195_2045022495809276,1,4,0,5,0.7717
1991716644473195_2045054972472695,1,0,0,1,0.5994
1991716644473195_2045101982467994,4,2,0,6,1.4596
1991716644473195_2045106205800905,0,3,0,3,0
1991716644473195_2045124182465774,18,3,0,21,8.4498
1991716644473195_2045124982465694,11,1,0,12,5.7859
1991716644473195_2045137569131102,6,0,0,6,3.0213
1991716644473195_2045147802463412,0,5,1,6,-0.296
1991716644473195_2045152209129638,1,4,2,7,0.3183
1991716644473195_2045174975794028,3,1,0,4,1.6392
1991716644473195_2045224575789068,0,2,0,2,0
1991716644473195_2045243255787200,1,1,0,2,0.5994
1991716644473195_2045247919120067,7,0,0,7,3.363
1991716644473195_2045265962451596,3,1,0,4,1.4613
1991716644473195_2045400745771451,0,3,0,3,0
1991716644473195_2045421632436029,1,4,0,5,0.5106
1991716644473195_2045656602412532,6,0,0,6,2.9226
1991716644473195_2045658169079042,9,1,0,10,4.9431
1991716644473195_2045696829075176,1,3,1,5,-0.2463
1991716644473195_2045743025737223,3,14,0,17,1.0184
1991716644473195_2045743799070479,3,3,0,6,1.4483
1991716644473195_2045752482402944,0,1,0,1,0
1991716644473195_2045795099065349,5,2,0,7,2.731
1991716644473195_2045799272398265,1,1,0,2,0.5994
1991716644473195_2045858699058989,9,0,0,9,4.6734
1991716644473195_2045880529056806,1,0,0,1,0.5994
1991716644473195_2045891599055699,13,1,0,14,6.7089
1991716644473195_2045913632386829,9,1,0,10,4.3834
1991716644473195_2045921989052660,1,2,1,4,0.3034
1991716644473195_2045982575713268,10,1,0,11,4.9924
1991716644473195_2046060239038835,14,0,0,14,7.1631
1991716644473195_2046072875704238,2,0,0,2,1.0398
1991716644473195_2046154985696027,1,3,0,4,0.5994
1991716644473195_2046199215691604,2,8,0,10,1.2089
1991716644473195_2046201152358077,0,3,0,3,0
1991716644473195_2046208159024043,0,2,0,2,0
1991716644473195_2046227519022107,4,4,1,9,1.4802
1991716644473195_2046241615687364,3,2,1,6,1.0692
1991716644473195_2046281779016681,0,6,2,8,-0.592
1991716644473195_2046290269015832,3,13,0,16,0.9451
1991716644473195_2046293252348867,2,0,1,3,0.8135
1991716644473195_2046316205679905,0,2,0,2,0
1991716644473195_2046331872345005,5,0,0,5,2.5011
1991716644473195_2046337699011089,1,0,0,1,0.5994
1991716644473195_2046346219010237,2,1,0,3,0.9431
1991716644473195_2046375739007285,1,3,0,4,0.5994
1991716644473195_2046432995668226,0,3,0,3,0
1991716644473195_2046703505641175,2,2,0,4,1.0398
1991716644473195_2046709508973908,3,2,0,5,1.8232
1991716644473195_2046718392306353,3,2,1,6,1.017
1991716644473195_2046773442300848,1,3,1,5,0.044
1991716644473195_2046790805632445,6,3,0,9,3.1307
1991716644473195_2046953038949555,13,8,0,21,8.0741
1991716644473195_2047063982271794,2,1,0,3,0.6142
1991716644473195_2047132445598281,0,1,0,1,0
1991716644473195_2047177542260438,0,6,3,9,-1.2402
1991716644473195_2047197182258474,0,4,0,4,0
1991716644473195_2047207015590824,0,12,0,12,0
1991716644473195_2047232328921626,0,4,0,4,0
1991716644473195_2047269425584583,1,0,0,1,0.5994
1991716644473195_2047294158915443,0,2,0,2,0
1991716644473195_2047296035581922,1,0,0,1,0.5994
1991716644473195_2047348592243333,0,1,0,1,0
1991716644473195_2047370235574502,4,5,1,10,1.5861
1991716644473195_2047675955543930,6,0,0,6,3.5083
1991716644473195_2047677552210437,1,1,0,2,0.0258
1991716644473195_2047682382209954,1,0,0,1,0.636
1991716644473195_2047692105542315,1,5,1,7,0
1991716644473195_2047727448872114,17,1,0,18,8.8521
1991716644473195_2047743705537155,2,4,0,6,0.976
1991716644473195_2047744152203777,15,7,0,22,8.2032
1991716644473195_2047825092195683,1,1,0,2,0.5994
1991716644473195_2047844792193713,16,3,0,19,8.3792
1991716644473195_2047850445526481,4,11,10,25,-2.3483
1991716644473195_2047851998859659,1,4,2,7,-0.45
1991716644473195_2047863765525149,4,1,0,5,2.0796
1991716644473195_2047907758854083,17,1,0,18,7.6633
1991716644473195_2047917038853155,5,2,0,7,2.679
1991716644473195_2047928888851970,7,0,0,7,3.7479
1991716644473195_2047967058848153,5,0,0,5,2.3232
1991716644473195_2048052842172908,3,1,0,4,1.7255
1991716644473195_2048103642167828,7,0,0,7,3.8775
1991716644473195_2048107218834137,0,6,3,9,-0.888
1991716644473195_2048166092161583,0,1,0,1,0
1991716644473195_2048226555488870,20,3,0,23,10.0012
1991716644473195_2048315445479981,6,1,0,7,3.1005
1991716644473195_2048599422118250,3,0,0,3,1.9752
1991716644473195_2048789392099253,0,2,0,2,0
1991716644473195_2048792898765569,2,2,0,4,1.0209
1991716644473195_2048883325423193,6,0,0,6,3.0074
1991716644473195_2048956832082509,3,0,0,3,1.2834
1991716644473195_2049089112069281,5,1,0,6,2.4154
1991716644473195_2049106422067550,2,0,0,2,1.1988
1991716644473195_2049125002065692,1,1,0,2,0.4404
1991716644473195_2049126722065520,3,3,0,6,1.3606
1991716644473195_2049232422054950,1,0,0,1,0.4404
1991716644473195_2049284545383071,1,1,0,2,0.5994
1991716644473195_2049716962006496,0,1,0,1,0
1991716644473195_2049828178662041,5,0,0,5,2.8981
1991716644473195_2049853055326220,4,2,0,6,1.7422
1991716644473195_2049907428654116,11,0,0,11,5.8735
1991716644473195_2049919605319565,2,0,0,2,0.8619
1991716644473195_2049920441986148,3,2,0,5,1.4613
1991716644473195_2049992941978898,5,0,0,5,2.7015
1991716644473195_2050064825305043,1,0,0,1,0.5994
1991716644473195_2050082458636613,6,0,0,6,3.2784
1991716644473195_2050236708621188,3,0,0,3,0.5563
1991716644473195_2050266278618231,0,1,0,1,0
1991716644473195_2050271268617732,8,2,0,10,4.2993
1991716644473195_2050278308617028,4,2,0,6,1.776
1991716644473195_2050285435282982,3,1,0,4,1.6392
1991716644473195_2050317055279820,2,0,0,2,1.0398
1991716644473195_2050321721946020,2,8,1,11,0.7973
1991716644473195_2050344258610433,3,0,1,4,1.5022
1991716644473195_2050823205229205,5,15,5,25,0.604
1991716644473195_2050954235216102,1,1,0,2,0.1779
1991716644473195_2050973971880795,7,16,2,25,2.3923
1991716644473195_2051016488543210,2,7,0,9,0.8407
1991716644473195_2051108861867306,4,0,0,4,2.2724
1991716644473195_2051143641863828,2,0,0,2,1.0209
1991716644473195_2051145175197008,6,0,0,6,3.1608
1991716644473195_2051154621862730,0,5,1,6,-0.296
1991716644473195_2051162821861910,5,2,0,7,2.8173
1991716644473195_2051167188528140,4,0,0,4,2.4175
1991716644473195_2051172478527611,3,0,0,3,1.6742
1991716644473195_2051179121860280,2,0,0,2,0.9812
1991716644473195_2051198111858381,4,1,0,5,2.1733
1991716644473195_2051217395189786,7,0,0,7,4.407
1991716644473195_2051236831854509,0,3,0,3,0
1991716644473195_2051246028520256,0,2,0,2,0
1991716644473195_2051260181852174,0,5,0,5,0
1991716644473195_2051267588518100,1,2,0,3,0.4404
1991716644473195_2051278388517020,2,3,0,5,1.1988
1991716644473195_2051292411848951,0,3,0,3,0
1991716644473195_2051298681848324,8,1,0,9,3.9813
1991716644473195_2051306978514161,3,0,0,3,1.5665
1991716644473195_2051699728474886,2,1,0,3,0.9176
1991716644473195_2051751458469713,2,0,0,2,1.0209
1991716644473195_2051798461798346,1,0,0,1,0.5994
1991716644473195_2051826031795589,2,1,0,3,1.1988
1991716644473195_2051915631786629,1,5,0,6,0.296
1991716644473195_2051918531786339,1,0,0,1,0.5994
1991716644473195_2051984165113109,2,0,0,2,1.284
1991716644473195_2052172611760931,0,1,0,1,0
1991716644473195_2052186751759517,9,0,0,9,4.6632
1991716644473195_2052190268425832,4,0,0,4,1.9017
1991716644473195_2052194481758744,2,0,0,2,0.7827
1991716644473195_2052197158425143,2,0,0,2,1.0209
1991716644473195_2052303781747814,0,1,0,1,0
1991716644473195_2052334181744774,4,0,0,4,2.0607
1991716644473195_2052352321742960,0,1,0,1,0
1991716644473195_2052376695073856,2,0,0,2,0.8619
1991716644473195_2052377268407132,2,0,0,2,1.0398
1991716644473195_2052427365068789,1,1,0,2,0.4404
1991716644473195_2052789615032564,0,1,0,1,0
1991716644473195_2052803058364553,3,0,0,3,1.3562
1991716644473195_2052826665028859,3,0,0,3,1.2834
1991716644473195_2052833718361487,1,0,0,1,0.4215
1991716644473195_2052933961684796,3,0,0,3,1.6392
1991716644473195_2052968515014674,0,0,1,1,-0.296
1991716644473195_2052990671679125,1,1,0,2,0.4404
1991716644473195_2052991081679084,2,0,0,2,0.9606
1991716644473195_2052999315011594,1,0,0,1,0.4215
1991716644473195_2053017221676470,1,0,0,1,0.4404
1991716644473195_2053043191673873,2,0,0,2,1.2231
1991716644473195_2053088888335970,1,3,1,5,-0.7351
1991716644473195_2053107685000757,0,1,0,1,0
1991716644473195_2053129008331958,6,0,0,6,2.4565
1991716644473195_2053201511658041,3,1,0,4,1.7306
1991716644473195_2053215594989966,0,2,0,2,0
1991716644473195_2053278174983708,1,0,0,1,0.4215
1991716644473195_2053293824982143,8,1,0,9,3.2982
1991716644473195_2053318101646382,2,0,0,2,0.9158
1991716644473195_2053358121642380,15,3,0,18,7.3242
1991716644473195_2053358544975671,5,2,0,7,2.1614
1991716644473195_2053411391637053,1,0,0,1,0.4215
1991716644473195_2053413628303496,1,4,0,5,0.1513
1991716644473195_2053422571635935,8,0,0,8,4.0081
1991716644473195_2053775908267268,7,1,0,8,3.369
1991716644473195_2053937541584438,4,4,0,8,2.437
1991716644473195_2053949094916616,2,8,1,11,0.3834
1991716644473195_2054021508242708,1,0,1,2,-0.2463
1991716644473195_2054036341574558,1,0,0,1,0.4215
1991716644473195_2054080941570098,5,0,0,5,2.3771
1991716644473195_2054087468236112,1,1,0,2,0.4215
1991716644473195_2054137178231141,3,0,0,3,1.0981
1991716644473195_2054148021563390,5,0,0,5,1.4378
1991716644473195_2054150441563148,6,5,0,11,2.6041
1991716644473195_2054159448228914,1,14,2,17,-0.296
1991716644473195_2054171274894398,5,1,0,6,2.6291
1991716644473195_2054173658227493,1,4,0,5,0.8225
1991716644473195_2054274758217383,2,0,0,2,0.8619
1991716644473195_2054295374881988,7,1,0,8,3.6938
1991716644473195_2054338458211013,4,0,0,4,1.7049
1991716644473195_2054352344876291,4,1,0,5,1.8894
1991716644473195_2054356701542522,1,0,0,1,0.9702
1991716644473195_2054362831541909,5,3,0,8,2.4758
1991716644473195_2054363634875162,6,1,0,7,2.8511
1991716644473195_2054383431539849,1,1,0,2,0.4215
1991716644473195_2054428181535374,2,1,0,3,0.8619
1991716644473195_2054815968163262,13,4,0,17,5.6036
1991716644473195_2054864828158376,18,3,0,21,9.2437
1991716644473195_2055207684790757,0,2,0,2,0
1991716644473195_2055285601449632,3,1,0,4,1.4424
1991716644473195_2055285784782947,4,0,0,4,2.3496
1991716644473195_2055414384770087,0,3,0,3,0
1991716644473195_2055489828095876,2,1,0,3,1.0398
1991716644473195_2055495444761981,17,2,0,19,8.3641
1991716644473195_2055499708094888,6,1,1,8,3.3899
1991716644473195_2055505808094278,3,0,0,3,1.4424
1991716644473195_2055509664760559,6,0,0,6,3.027
1991716644473195_2055563368088522,0,2,0,2,0
1991716644473195_2055881098056749,1,1,0,2,0.4754
1991716644473195_2055884558056403,4,1,0,5,2.0472
1991716644473195_2055900234721502,0,1,0,1,0
1991716644473195_2055900988054760,2,1,0,3,0.8808
1991716644473195_2055901881388004,2,0,0,2,0.8808
1991716644473195_2056036148041244,6,0,0,6,2.9415
1991716644473195_2056065118038347,0,2,0,2,0
1991716644473195_2056085128036346,16,4,0,20,8.2481
1991716644473195_2056097314701794,6,1,0,7,2.906
1991716644473195_2056173661360826,3,0,0,3,1.5665
1991716644473195_2056211298023729,3,2,0,5,1.5325
1991716644473195_2056267518018107,1,0,0,1,0.4215
1991716644473195_2056309204680605,19,4,2,25,7.9983
1991716644473195_2056324481345744,0,7,0,7,0
1991716644473195_2056328524678673,6,3,0,9,2.9831
1991716644473195_2056339481344244,0,1,0,1,0
1991716644473195_2056376461340546,4,0,0,4,2.2566
1991716644473195_2056378331340359,1,0,0,1,0.4215
1991716644473195_2056406304670895,9,1,0,10,4.6718
1991716644473195_2056527104658815,4,0,0,4,2.2381
1991716644473195_2056579314653594,2,0,0,2,1.0021
1991716644473195_2057142361263956,9,0,0,9,5.0776
1991716644473195_2057227597922099,2,1,0,3,1.1988
1991716644473195_2057265627918296,2,1,0,3,1.1988
1991716644473195_2057282077916651,4,2,0,6,2.4175
1991716644473195_2057354971242695,2,1,0,3,1.0398
1991716644473195_2057409777903881,9,0,0,9,4.6431
1991716644473195_2057431964568329,4,0,0,4,2.3556
1991716644473195_2057437131234479,1,4,0,5,0.4215
1991716644473195_2057693644542161,3,1,0,4,2.0064
1991716644473195_2057695967875262,3,0,0,3,1.4613
1991716644473195_2057773947867464,1,1,0,2,0.5994
1991716644473195_2057783547866504,5,3,0,8,2.396
1991716644473195_2057785481199644,1,1,0,2,0.2023
1991716644473195_2058251454486380,2,0,0,2,1.2187
1991716644473195_2058298524481673,1,0,0,1,0.4215
1991716644473195_2058298827814976,2,0,0,2,0.843
1991716644473195_2058472024464323,24,1,0,25,11.8502
1991716644473195_2058487294462796,6,1,0,7,2.8871
1991716644473195_2058488071129385,10,2,0,12,4.9143
1991716644473195_2058530501125142,6,0,0,6,3.1084
1991716644473195_2058559921122200,1,3,0,4,0.296
1991716644473195_2058629594448566,1,0,0,1,0.636
1991716644473195_2058638721114320,2,0,0,2,0.9142
1991716644473195_2058661797778679,19,4,2,25,8.826
1991716644473195_2058663601111832,2,2,0,4,1.4251
1991716644473195_2058671654444360,1,0,0,1,0.6249
1991716644473195_2058677764443749,5,1,0,6,2.3528
1991716644473195_2058684601109732,1,1,0,2,0.4404
1991716644473195_2058685144443011,3,1,0,4,1.5136
1991716644473195_2058736027771256,5,1,1,7,1.3264
1991716644473195_2058745394436986,5,0,0,5,2.7156
1991716644473195_2058763441101848,1,0,0,1,0.4404
1991716644473195_2058788911099301,1,5,0,6,0.5106
1991716644473195_2058793487765510,11,1,0,12,5.7115
1991716644473195_2058795987765260,6,1,0,7,3.1527
1991716644473195_2058830024428523,0,2,0,2,0
1991716644473195_2058831334428392,2,0,0,2,0.8808
1991716644473195_2058849777759881,1,9,0,10,0.7184
1991716644473195_2058868111091381,2,7,2,11,-0.056
1991716644473195_2058883091089883,1,1,0,2,0.5267
1991716644473195_2058887911089401,7,1,0,8,3.2752
1991716644473195_2058890741089118,4,1,0,5,1.7572
1991716644473195_2058901304421395,6,0,0,6,2.8849
1991716644473195_2058967134414812,6,0,0,6,3.1377
1991716644473195_2058970961081096,13,3,0,16,6.5251
1991716644473195_2059347444376781,3,0,0,3,1.3023
1991716644473195_2059417694369756,3,0,0,3,1.3735
1991716644473195_2059447397700119,7,2,0,9,3.2714
1991716644473195_2059448017700057,9,1,0,10,4.793
1991716644473195_2059451407699718,2,0,0,2,0.8016
1991716644473195_2059545777690281,4,3,0,7,2.0995
1991716644473195_2059578617686997,2,20,3,25,0.0245
1991716644473195_2059579751020217,7,13,2,22,3.7355
1991716644473195_2059590794352446,2,2,0,4,1.1988
1991716644473195_2059627647682094,7,1,0,8,4.0591
1991716644473195_2059654864346039,0,2,0,2,0
1991716644473195_2059701764341349,2,0,0,2,1.2455
1991716644473195_2059702851007907,7,17,1,25,3.4653
1991716644473195_2059803924331133,2,1,0,3,1.0074
1991716644473195_2059820907662768,1,0,0,1,0.5994
1991716644473195_2059825350995657,3,12,1,16,1.7371
1991716644473195_2059827574328768,7,0,0,7,3.7927
1991716644473195_2059831190995073,24,1,0,25,12.8977
1991716644473195_2059834374328088,9,3,0,12,3.9378
1991716644473195_2059844517660407,2,0,0,2,0.8619
1991716644473195_2059856637659195,13,1,0,14,7.4199
1991716644473195_2059873774324148,6,1,0,7,2.7447
1991716644473195_2059878630990329,7,0,0,7,3.3098
1991716644473195_2059879777656881,14,2,0,16,7.2662
1991716644473195_2059882867656572,5,11,2,18,2.2364
1991716644473195_2059905417654317,5,5,0,10,2.361
1991716644473195_2059914910986701,6,0,0,6,3.0437
1991716644473195_2059916937653165,0,6,0,6,0
1991716644473195_2059928977651961,1,0,0,1,0.4404
1991716644473195_2059929304318595,0,1,0,1,0
1991716644473195_2059967774314748,1,3,1,5,0.1975
1991716644473195_2059982214313304,0,1,0,1,0
1991716644473195_2059999570978235,1,1,0,2,0.4215
1991716644473195_2060034000974792,6,2,0,8,3.284
1991716644473195_2060037720974420,1,1,2,4,-0.4479
1991716644473195_2060043527640506,0,2,0,2,0
1991716644473195_2060049234306602,1,9,1,11,-0.1059
1991716644473195_2060051204306405,1,4,2,7,-0.4215
1991716644473195_2060056324305893,23,2,0,25,10.3802
1991716644473195_2060072037637655,5,2,6,13,0.498
1991716644473195_2060124640965728,1,0,0,1,0.4404
1991716644473195_2060401210938071,2,8,2,12,0.2666
1991716644473195_2060413560936836,1,1,0,2,0.4215
1991716644473195_2060416377603221,6,1,0,7,2.9601
1991716644473195_2060429234268602,11,0,0,11,5.1104
1991716644473195_2060442064267319,3,2,0,5,1.7814
1991716644473195_2060459194265606,0,1,0,1,0
1991716644473195_2060474890930703,4,0,0,4,2.2057
1991716644473195_2060481757596683,1,4,0,5,0.0516
1991716644473195_2060484924263033,9,1,0,10,4.5911
1991716644473195_2060510884260437,0,1,3,4,-1.0301
1991716644473195_2060527960925396,1,2,2,5,-0.5148
1991716644473195_2060540174257508,5,3,0,8,2.2349
1991716644473195_2060569770921215,0,10,3,13,-0.9939
1991716644473195_2060598997584959,0,5,2,7,-0.6979
1991716644473195_2060626857582173,2,2,0,4,0.9665
1991716644473195_2060658610912331,3,1,2,6,0.7977
1991716644473195_2060675970910595,1,8,4,13,-1.7711
1991716644473195_2060713127573546,0,1,0,1,0
1991716644473195_2060736444237881,2,2,1,5,0.5049
1991716644473195_2060754237569435,10,3,0,13,5.1524
1991716644473195_2060758770902315,1,2,0,3,0.3182
1991716644473195_2060812627563596,4,3,0,7,1.954
1991716644473195_2060895874221938,2,8,3,13,-0.0786
1991716644473195_2060904570887735,2,1,0,3,1.0398
1991716644473195_2060966880881504,6,1,0,7,3.2644
1991716644473195_2061018937542965,3,0,0,3,1.2645
1991716644473195_2061035077541351,4,0,0,4,2.0292
1991716644473195_2061055824205943,8,1,0,9,4.0431
1991716644473195_2061089634202562,1,0,0,1,0.4215
1991716644473195_2061139927530866,2,0,0,2,0.843
1991716644473195_2061163594195166,2,4,0,6,1.2945
1991716644473195_2061163637528495,3,0,0,3,1.3212
1991716644473195_2061476100830582,1,1,0,2,0.4215
1991716644473195_2061537647491094,2,1,0,3,0.2795
1991716644473195_2061578464153679,2,0,0,2,0.843
1991716644473195_2061598934151632,3,0,0,3,1.4613
1991716644473195_2061762297468629,3,0,0,3,1.3212
1991716644473195_2061776640800528,23,2,0,25,12.1005
1991716644473195_2061776690800523,5,1,0,6,2.2694
1991716644473195_2061788627465996,1,0,0,1,0.4215
1991716644473195_2061802690797923,6,1,0,7,3.3277
1991716644473195_2061821530796039,2,0,0,2,1.4652
1991716644473195_2061829320795260,8,10,0,18,4.0675
1991716644473195_2061845527460306,6,1,0,7,2.5479
1991716644473195_2061849454126580,6,0,0,6,2.5857
1991716644473195_2061853844126141,0,1,0,1,0
1991716644473195_2061866810791511,5,6,0,11,2.8909
1991716644473195_2061885514122974,2,2,0,4,0.8619
1991716644473195_2061964304115095,4,6,0,10,2.0431
1991716644473195_2061999530778239,4,1,0,5,1.7049
1991716644473195_2062001430778049,5,2,0,7,2.9243
1991716644473195_2062003574111168,2,7,1,10,0.5546
1991716644473195_2062004957444363,0,1,0,1,0
1991716644473195_2062005640777628,4,1,0,5,1.7427
1991716644473195_2062011687443690,4,1,0,5,1.8101
1991716644473195_2062026450775547,2,2,0,4,0.8808
1991716644473195_2062101474101378,1,0,0,1,0.4215
1991716644473195_2062117894099736,3,0,0,3,1.3357
1991716644473195_2062148250763367,6,1,0,7,3.5478
1991716644473195_2062160494095476,1,0,0,1,0.4404
1991716644473195_2062180594093466,4,0,0,4,1.7427
1991716644473195_2062180777426781,3,0,0,3,1.2834
1991716644473195_2062188127426046,10,0,0,10,4.781
1991716644473195_2062191890759003,1,0,0,1,0.7579
1991716644473195_2062204004091125,1,0,0,1,0.4215
1991716644473195_2062207294090796,0,7,0,7,0
1991716644473195_2062231477421711,5,2,0,7,2.4123
1991716644473195_2062233627421496,13,5,0,18,5.9079
1991716644473195_2062529234058602,5,2,0,7,2.839
1991716644473195_2062541600724032,6,1,0,7,2.7636
1991716644473195_2062555280722664,6,1,0,7,3.4025
1991716644473195_2062555704055955,4,0,0,4,2.2386
1991716644473195_2062633850714807,2,4,0,6,0.7586
1991716644473195_2062701517374707,1,5,0,6,0.4404
1991716644473195_2062718814039644,1,0,0,1,0.4404
1991716644473195_2062836340694558,2,1,0,3,1.0398
1991716644473195_2062912604020265,2,0,0,2,0.843
1991716644473195_2062933124018213,3,1,0,4,1.5928
1991716644473195_2062935777351281,4,1,0,5,1.9088
1991716644473195_2062958190682373,1,0,0,1,0.4215
1991716644473195_2062970604014465,10,1,0,11,4.8564
1991716644473195_2062979524013573,6,1,0,7,2.7636
1991716644473195_2062984260679766,4,2,0,6,2.2167
1991716644473195_2063008537344005,4,3,0,7,2.4886
1991716644473195_2063011300677062,1,4,1,6,0.6324
1991716644473195_2063015180676674,8,4,0,12,3.4287
1991716644473195_2063028230675369,2,7,0,9,1.0052
1991716644473195_2063088974002628,2,0,0,2,0.843
1991716644473195_2063102460667946,1,1,0,2,0.5994
1991716644473195_2063153073996218,0,3,0,3,0
1991716644473195_2063203230657869,21,2,0,23,10.5005
1991716644473195_2063204747324384,6,1,0,7,2.9765
1991716644473195_2063252847319574,3,0,0,3,1.4799
1991716644473195_2063255860652606,2,1,0,3,0.843
1991716644473195_2063257470652445,6,2,0,8,2.7797
1991716644473195_2063278140650378,6,0,0,6,2.7361
1991716644473195_2063341630644029,7,0,0,7,3.0989
1991716644473195_2063343993977126,4,0,0,4,1.5755
1991716644473195_2063383063973219,5,1,0,6,2.1803
1991716644473195_2063383243973201,9,1,0,10,3.9337
1991716644473195_2063464857298373,6,0,0,6,2.7258
1991716644473195_2063465237298335,4,0,0,4,1.7238
1991716644473195_2063562123955313,3,0,0,3,1.2834
1991716644473195_2063732160604976,2,1,0,3,0.8619
1991716644473195_2063744253937100,6,1,0,7,2.8434
1991716644473195_2063769293934596,1,4,0,5,0.296
1991716644473195_2063784453933080,9,1,0,10,4.1522
1991716644473195_2063784703933055,1,2,2,5,-0.3567
1991716644473195_2063853623926163,10,1,0,11,5.1946
1991716644473195_2063892323922293,1,3,0,4,0.4767
1991716644473195_2063894700588722,1,1,1,3,-0.2188
1991716644473195_2063943160583876,2,3,0,5,1.1312
1991716644473195_2063962810581911,1,1,0,2,0.4939
1991716644473195_2063969110581281,2,0,0,2,0.8969
1991716644473195_2063973810580811,2,2,0,4,1.0209
1991716644473195_2063983523913173,0,3,0,3,0
1991716644473195_2063996930578499,18,3,0,21,8.7862
1991716644473195_2064038303907695,0,2,1,3,-0.296
1991716644473195_2064048177240041,2,0,0,2,1.0653
1991716644473195_2064060317238827,1,0,0,1,0.5267
1991716644473195_2064120530566139,2,1,0,3,0.8619
1991716644473195_2064149170563275,5,1,0,6,2.5701
1991716644473195_2064174300560762,2,0,0,2,1.0653
1991716644473195_2064178967226962,2,0,0,2,0.8619
1991716644473195_2064213787223480,10,3,1,14,4.2103
1991716644473195_2064217540556438,3,0,0,3,1.5136
1991716644473195_2064225503888975,2,0,0,2,0.843
1991716644473195_2064234440554748,5,0,0,5,2.3421
1991716644473195_2064236983887827,4,1,0,5,1.7427
1991716644473195_2064256903885835,1,0,0,1,0.4404
1991716644473195_2064262840551908,0,3,0,3,0
1991716644473195_2064289583882567,1,8,2,11,-0.252
1991716644473195_2064301827214676,23,2,0,25,11.5584
1991716644473195_2064318790546313,10,2,0,12,4.529
1991716644473195_2064371600541032,3,1,0,4,1.4802
1991716644473195_2064384000539792,0,1,0,1,0
1991716644473195_2064385233873002,0,4,0,4,0
1991716644473195_2064411280537064,1,0,0,1,0.4215
1991716644473195_2064414267203432,0,1,0,1,0
1991716644473195_2064428793868646,19,6,0,25,10.0332
1991716644473195_2064494873862038,3,0,0,3,1.6203
1991716644473195_2064502343861291,2,0,0,2,0.8619
1991716644473195_2064740537170805,10,1,0,11,4.2906
1991716644473195_2064769643834561,0,1,0,1,0
1991716644473195_2064777607167098,0,5,0,5,0
1991716644473195_2064799363831589,1,0,0,1,0.4215
1991716644473195_2064871543824371,2,6,0,8,1.1988
1991716644473195_2064880783823447,11,3,0,14,6.3791
1991716644473195_2064894587155400,0,4,0,4,0
1991716644473195_2064957757149083,1,0,0,1,0.4215
1991716644473195_2065012767143582,8,4,0,12,3.9624
1991716644473195_2065017573809768,4,3,0,7,1.9017
1991716644473195_2065023640475828,3,1,0,4,1.4802
1991716644473195_2065034843808041,2,0,0,2,1.0209
1991716644473195_2065069643804561,0,5,1,6,-0.296
1991716644473195_2065070413804484,1,5,0,6,0.6249
1991716644473195_2065079897136869,1,0,0,1,0.4404
1991716644473195_2065089407135918,3,0,0,3,1.3023
1991716644473195_2065095863801939,4,0,0,4,1.7238
1991716644473195_2065112073800318,1,0,0,1,0.5994
1991716644473195_2065130027131856,22,3,0,25,10.5043
1991716644473195_2065132780464914,0,8,0,8,0
1991716644473195_2065134250464767,4,2,0,6,1.9206
1991716644473195_2065149410463251,7,1,0,8,3.6462
1991716644473195_2065223190455873,0,3,0,3,0
1991716644473195_2065309960447196,4,2,0,6,2.1797
1991716644473195_2065340460444146,1,0,0,1,0.4215
1991716644473195_2065421607102698,2,1,0,3,1.0209
1991716644473195_2065525813758944,1,2,0,3,0.7149
1991716644473195_2065704230407769,3,0,0,3,1.6832
1991716644473195_2065833883728137,2,0,0,2,1.0209
1991716644473195_2065948003716725,2,0,0,2,0.843
1991716644473195_2065985400379652,7,0,0,7,4.0741
1991716644473195_2066081327036726,1,0,0,1,0.4215
1991716644473195_2066145263696999,3,0,0,3,1.3023
1991716644473195_2066204700357722,4,2,0,6,1.7238
1991716644473195_2066237170354475,3,1,0,4,1.2834
1991716644473195_2066284103683115,2,0,0,2,0.843
1991716644473195_2066291160349076,11,6,0,17,4.6967
1991716644473195_2066338690344323,5,1,0,6,2.3953
1991716644473195_2066339087010950,2,3,0,5,0.8619
1991716644473195_2066377773673748,3,1,0,4,2.0112
1991716644473195_2066386930339499,8,2,0,10,4.0101
1991716644473195_2066409297003929,2,0,0,2,0.8969
1991716644473195_2066411160337076,2,0,0,2,0.843
1991716644473195_2066425933668932,4,1,0,5,2.1288
1991716644473195_2066461633665362,0,0,1,1,-0.0191
1991716644473195_2066469630331229,5,0,0,5,2.6508
1991716644473195_2066476596997199,3,1,0,4,1.4424
1991716644473195_2066476693663856,1,1,0,2,0.4404
1991716644473195_2066488026996056,0,3,0,3,0
1991716644473195_2066494356995423,6,0,0,6,3.3003
1991716644473195_2066500213661504,0,3,0,3,0
1991716644473195_2066501873661338,2,0,0,2,0.8619
1991716644473195_2066506170327575,3,0,0,3,1.6323
1991716644473195_2066511980326994,3,1,0,4,1.2834
1991716644473195_2066528376992021,0,2,0,2,0
1991716644473195_2066549940323198,3,0,0,3,1.5622
1991716644473195_2066553493656176,2,0,0,2,0.8968
1991716644473195_2066559853655540,1,2,1,4,0.0222
1991716644473195_2066583860319806,4,0,0,4,2.4837
1991716644473195_2066599573651568,1,0,0,1,0.5399
1991716644473195_2066647996980059,5,0,0,5,2.248
1991716644473195_2066684436976415,0,1,0,1,0
1991716644473195_2066725393638986,7,0,0,7,3.1969
1991716644473195_2066728936971965,2,6,1,9,0.34
1991716644473195_2066750746969784,7,0,1,8,2.8916
1991716644473195_2066755336969325,3,2,0,5,1.1902
1991716644473195_2066804540297738,5,2,0,7,2.7168
1991716644473195_2066997413611784,1,0,0,1,0.4215
1991716644473195_2067012783610247,5,0,0,5,2.4944
1991716644473195_2067014513610074,1,0,0,1,0.4215
1991716644473195_2067030053608520,1,1,0,2,0.4215
1991716644473195_2067043976940461,0,1,0,1,0
1991716644473195_2067052973606228,4,0,0,4,1.8849
1991716644473195_2067079016936957,4,1,0,5,2.0891
1991716644473195_2067113320266860,5,1,0,6,2.1976
1991716644473195_2067194520258740,8,1,0,9,3.813
1991716644473195_2067197280258464,2,1,0,3,0.8619
1991716644473195_2067214310256761,6,7,0,13,3.111
1991716644473195_2067239483587577,4,0,0,4,1.8518
1991716644473195_2067267193584806,8,0,0,8,4.6954
1991716644473195_2067274693584056,3,2,0,5,1.479
1991716644473195_2067281480250044,1,1,0,2,0.4215
1991716644473195_2067342490243943,1,0,0,1,0.4215
1991716644473195_2067378110240381,4,0,0,4,1.7238
1991716644473195_2067388286906030,2,0,0,2,0.843
1991716644473195_2067395080238684,6,1,0,7,3.3272
1991716644473195_2067431133568412,3,0,0,3,1.2834
1991716644473195_2067440850234107,9,3,0,12,4.3869
1991716644473195_2067461926898666,1,7,1,9,-0.2463
1991716644473195_2067469526897906,4,1,0,5,1.9272
1991716644473195_2067474040230788,1,1,0,2,0.4215
1991716644473195_2067474803564045,5,0,0,5,2.3226
1991716644473195_2067503903561135,3,0,0,3,1.3023
1991716644473195_2067526623558863,1,0,0,1,0.4215
1991716644473195_2067534633558062,7,2,0,9,3.4258
1991716644473195_2067543106890548,3,4,0,7,1.4424
1991716644473195_2067560746888784,7,0,0,7,3.9225
1991716644473195_2067563296888529,1,0,0,1,0.4215
1991716644473195_2067578250220367,1,1,0,2,0.4215
1991716644473195_2067583886886470,4,0,0,4,1.8828
1991716644473195_2067594890218703,5,0,0,5,2.4294
1991716644473195_2067620953549430,1,0,0,1,0.3612
1991716644473195_2067637666881092,2,0,0,2,1.3031
1991716644473195_2067663806878478,6,3,1,10,2.9986
1991716644473195_2067692796875579,3,1,0,4,1.2834
1991716644473195_2067730340205158,2,1,0,3,0.8619
1991716644473195_2067739140204278,3,2,0,5,1.6392
1991716644473195_2067743433537182,1,4,1,6,-0.2759
1991716644473195_2067744203537105,1,0,0,1,0.4215
1991716644473195_2067746796870179,3,0,0,3,1.2645
1991716644473195_2067762333535292,5,1,0,6,1.8997
1991716644473195_2067762710201921,6,3,1,10,3.1414
1991716644473195_2067768053534720,2,7,1,10,0.2643
1991716644473195_2067789973532528,13,3,0,16,7.2088
1991716644473195_2067803820197810,2,0,0,2,0.8619
1991716644473195_2067817826863076,2,0,0,2,0.7827
1991716644473195_2067822486862610,7,1,0,8,3.6333
1991716644473195_2067849343526591,2,0,0,2,0.843
1991716644473195_2068107866834072,1,0,1,2,0.3377
1991716644473195_2068170780161114,2,1,0,3,1.0263
1991716644473195_2068232976821561,2,0,0,2,0.8619
1991716644473195_2068350906809768,1,8,0,9,0.5514
1991716644473195_2068429416801917,3,0,0,3,1.4018
1991716644473195_2068456116799247,2,1,0,3,1.0464
1991716644473195_2068561083455417,23,2,0,25,10.6467
1991716644473195_2068675276777331,2,0,0,2,1.0209
1991716644473195_2068764203435105,2,0,0,2,1.0209
1991716644473195_2068766750101517,5,0,0,5,2.1831
1991716644473195_2068790216765837,2,16,1,19,0.5489
1991716644473195_2068797086765150,0,1,0,1,0
1991716644473195_2068797940098398,2,9,0,11,1.0208
1991716644473195_2068834393428086,3,6,0,9,0.6964
1991716644473195_2068964143415111,0,1,0,1,0
1991716644473195_2069312210046971,2,1,0,3,1.0209
1991716644473195_2069410066703852,6,0,0,6,3.1796
1991716644473195_2069532706691588,2,1,0,3,1.0209
1991716644473195_2069559490022243,2,2,0,4,0.5928
1991716644473195_2069619116682947,5,0,0,5,2.7117
1991716644473195_2069657040012488,3,0,0,3,1.2042
1991716644473195_2069714450006747,8,0,0,8,4.4229
1991716644473195_2069762566668602,1,1,0,2,0.5106
1991716644473195_2069763113335214,4,0,0,4,2.2452
1991716644473195_2069833206661538,2,1,0,3,0.7827
1991716644473195_2069874113324114,9,3,0,12,5.6128
1991716644473195_2069935253318000,3,0,0,3,1.4149
1991716644473195_2069942443317281,1,0,1,2,0.2258
1991716644473195_2070001819978010,5,0,0,5,2.1264
1991716644473195_2070428663268659,7,13,5,25,2.1622
1991716644473195_2070441439934048,0,1,0,1,0
1991716644473195_2070469236597935,0,0,1,1,-0.3612
1991716644473195_2070497246595134,7,1,0,8,2.2808
1991716644473195_2070512346593624,11,6,1,18,4.4738
1991716644473195_2070520739926118,1,4,0,5,0.5423
1991716644473195_2070541319924060,7,2,0,9,3.592
1991716644473195_2070562436588615,8,0,0,8,4.1273
1991716644473195_2070634383248087,1,0,0,1,0.4215
1991716644473195_2070686193242906,2,1,1,4,1.2282
1991716644473195_2070746183236907,5,16,2,23,1.6949
1991716644473195_2070757519902440,0,2,0,2,0
1991716644473195_2070761543235371,2,2,0,4,0.7419
1991716644473195_2070817329896459,4,2,0,6,2.0418
1991716644473195_2070840879894104,2,5,0,7,1.0105
1991716644473195_2070846749893517,1,2,0,3,0.34
1991716644473195_2070848239893368,5,17,2,24,0.6902
1991716644473195_2070917649886427,3,9,0,12,1.4263
1991716644473195_2070932653218260,0,3,0,3,0
1991716644473195_2070968843214641,2,0,0,2,1.1988
1991716644473195_2071132713198254,4,0,0,4,2.2021
1991716644473195_2071346766510182,3,1,0,4,1.4409
1991716644473195_2071449703166555,3,2,0,5,1.3129
1991716644473195_2071475693163956,7,13,5,25,1.2296
1991716644473195_2071479326496926,3,7,0,10,0.8434
1991716644473195_2071494756495383,4,2,0,6,2.0143
1991716644473195_2071496663161859,1,15,0,16,0.4019
1991716644473195_2071499829828209,4,0,0,4,2.1197
1991716644473195_2071543959823796,1,0,0,1,0.4215
1991716644473195_2071577036487155,0,4,0,4,0
1991716644473195_2071610309817161,0,0,1,1,-0.296
1991716644473195_2071615479816644,5,4,0,9,1.2306
1991716644473195_2071622403149285,1,0,0,1,0.4215
1991716644473195_2071719616472897,0,6,0,6,0
1991716644473195_2071721536472705,0,1,0,1,0
1991716644473195_2071761193135406,1,0,0,1,0.4215
1991716644473195_2071774666467392,12,0,0,12,5.9627
1991716644473195_2071782806466578,1,0,0,1,0.4215
1991716644473195_2071867343124791,0,2,0,2,0
1991716644473195_2071964609781731,2,5,0,7,1.0074
1991716644473195_2071980059780186,3,0,0,3,1.2645
1991716644473195_2072043819773810,0,3,3,6,-0.888
1991716644473195_2072067606438098,5,1,0,6,2.1642
1991716644473195_2072183463093179,10,3,0,13,4.7214
1991716644473195_2072230749755117,2,0,0,2,0.7397
1991716644473195_2072320779746114,4,1,0,5,1.7049
1991716644473195_2072602853051240,1,2,2,5,-0.6758
1991716644473195_2072604209717771,0,7,3,10,-1.2828
1991716644473195_2072771763034349,1,0,0,1,0.5859
1991716644473195_2072777263033799,3,0,0,3,2.1494
1991716644473195_2072821246362734,1,0,0,1,0.5204
1991716644473195_2072834129694779,5,0,0,5,2.1453
1991716644473195_2072843399693852,0,2,0,2,0
1991716644473195_2072864569691735,3,4,2,9,0.9863
1991716644473195_2072943683017157,2,0,0,2,1.1878
1991716644473195_2072949226349936,1,0,0,1,0.4215
1991716644473195_2072989673012558,6,1,0,7,3.5702
1991716644473195_2073041023007423,1,1,0,2,0.5994
1991716644473195_2073091739669018,2,0,0,2,0.843
1991716644473195_2073101846334674,0,2,0,2,0
1991716644473195_2073141092997416,1,5,3,9,-1.0846
1991716644473195_2073229792988546,21,1,1,23,9.5541
1991716644473195_2073278109650381,1,7,0,8,0.4404
1991716644473195_2073284162983109,0,6,3,9,-0.888
1991716644473195_2073328309645361,0,1,0,1,0
1991716644473195_2073340786310780,9,2,4,15,2.9325
1991716644473195_2073436949634497,0,1,0,1,0
1991716644473195_2073444242967101,2,0,0,2,0.8808
1991716644473195_2073797236265135,4,0,0,4,2.2482
1991716644473195_2073855246259334,4,4,1,9,1.0651
1991716644473195_2073893126255546,9,14,2,25,2.9659
1991716644473195_2073894246255434,4,6,0,10,2.5053
1991716644473195_2073958369582355,1,0,0,1,0.4215
1991716644473195_2073960106248848,5,2,0,7,1.8549
1991716644473195_2074113796233479,2,0,0,2,1.0747
1991716644473195_2074432582868267,0,3,0,3,0
1991716644473195_2074434069534785,9,3,0,12,4.5731
1991716644473195_2074448739533318,2,2,0,4,1.0398
1991716644473195_2075044439473748,1,0,0,1,0.4215
1991716644473195_2075270892784436,5,1,1,7,2.0811
1991716644473195_2075275499450642,5,0,0,5,1.91
1991716644473195_2075314176113441,3,0,0,3,1.3023
1991716644473195_2075425946102264,3,0,0,3,1.7805
1991716644473195_2075428979435294,0,1,0,1,0
1991716644473195_2075910076053851,3,18,3,24,-0.2507
1991716644473195_2075956339382558,3,14,0,17,1.6513
1991716644473195_2076145966030262,7,0,0,7,3.8291
1991716644473195_2076157582695767,19,2,0,21,9.4516
1991716644473195_2076349669343225,0,7,0,7,0
1991716644473195_2076594739318718,7,5,0,12,3.1118
1991716644473195_2076907515954107,1,0,0,1,0.4404
1991716644473195_2078278855816973,2,1,0,3,1.0994
1991716644473195_2078283329149859,18,5,2,25,5.8182
1991716644473195_2078288129149379,11,3,0,14,7.0918
1991716644473195_2078345285810330,5,0,0,5,2.6667
1991716644473195_2078364099141782,4,2,0,6,2.0806
1991716644473195_2078505785794280,6,1,0,7,3.064
1991716644473195_2078574145787444,5,1,0,6,2.1831
1991716644473195_2078657909112401,2,1,0,3,0.843
1991716644473195_2079340029044189,5,9,1,15,2.3088
1991716644473195_2080902675554591,4,0,0,4,2.1515
1991716644473195_2081690338809158,6,3,1,10,1.6574
1991716644473195_2082064212105104,21,0,0,21,9.2722
1991716644473195_2082828915361967,1,5,0,6,0.4588
1991716644473195_2082940218684170,2,3,1,6,0.495
1991716644473195_2084725525172306,5,2,0,7,3.6957
1991716644473195_2086106938367498,14,1,0,15,6.0782
1991716644473195_2086110551700470,11,6,0,17,6.7172
1991716644473195_2086116261699899,7,5,0,12,4.0188
1991716644473195_2086632791648246,2,0,0,2,1.1673
1991716644473195_2087073751604150,3,0,0,3,2.043
1991716644473195_2088232584821600,0,1,0,1,0
1991716644473195_2088634314781427,3,1,0,4,1.2638
1991716644473195_2089261634718695,4,2,1,7,1.5416
1991716644473195_2090243177953874,4,0,0,4,1.9931
1991716644473195_2094092514235607,24,1,0,25,11.5399
1991716644473195_2096236044021254,8,0,1,9,3.9923
1991716644473195_2096689977309194,0,1,1,2,-0.1027
1991716644473195_2097114967266695,0,1,0,1,0
1991716644473195_2098371623807696,4,1,0,5,1.7238
1991716644473195_2099554250356100,1,2,0,3,0.4404
1991716644473195_2099789556999236,3,22,0,25,2.3139
1991716644473195_2100808380230687,3,18,4,25,-1.0598
1991716644473195_2100845090227016,9,12,4,25,0.7362
1991716644473195_2100887283556130,2,20,3,25,0.1673
1991716644473195_2100900726888119,4,21,0,25,1.7581
1991716644473195_2100944703550388,6,14,2,22,0.3967
1991716644473195_2101026196875572,0,3,0,3,0
1991716644473195_2101028876875304,0,1,0,1,0
1991716644473195_2101039643540894,4,19,2,25,0.5411
1991716644473195_2101103513534507,0,1,0,1,0
1991716644473195_2101270643517794,3,20,2,25,0.3895
1991716644473195_2101453110166214,1,1,1,3,0.0697
1991716644473195_2101488596829332,5,10,0,15,2.4989
1991716644473195_2101590266819165,17,8,0,25,8.7692
1991716644473195_2101594886818703,4,16,0,20,1.6496
1991716644473195_2101632146814977,2,4,1,7,-0.0287
1991716644473195_2101644533480405,1,5,0,6,0.296
1991716644473195_2101818086796383,0,5,0,5,0
1991716644473195_2101819590129566,2,4,2,8,0.0924
1991716644473195_2101844580127067,1,2,0,3,0.8271
1991716644473195_2101860783458780,1,3,1,5,0.5311
1991716644473195_2101869166791275,1,4,0,5,0.824
1991716644473195_2101872623457596,0,13,1,14,-0.3612
1991716644473195_2101912410120284,2,5,1,8,0.4459
1991716644473195_2101919406786251,1,2,0,3,0.5574
1991716644473195_2101920713452787,1,2,0,3,0.3182
1991716644473195_2102059823438876,4,2,0,6,2.3589
1991716644473195_2102077440103781,1,5,1,7,-0.4651
1991716644473195_2102090746769117,2,8,2,12,0.1527
1991716644473195_2102131613431697,1,7,1,9,0.1555
1991716644473195_2102329103411948,0,1,1,2,-0.2263
1991716644473195_2102337896744402,2,3,4,9,-0.5489
1991716644473195_2102370410074484,2,3,1,6,-0.0065
1991716644473195_2102379320073593,0,1,0,1,0
1991716644473195_2102380566740135,2,0,0,2,0.8808
1991716644473195_2102423910069134,2,11,2,15,0.0892
1991716644473195_2102449253399933,0,3,0,3,0
1991716644473195_2102493426728849,2,5,1,8,0.8426
1991716644473195_2102500296728162,0,4,1,5,-0.4019
1991716644473195_2102549890056536,0,1,0,1,0
1991716644473195_2102575826720609,0,2,0,2,0
1991716644473195_2102605260050999,2,4,0,6,0.8066
1991716644473195_2102696890041836,2,3,0,5,0.8234
1991716644473195_2102699893374869,1,0,0,1,0.34
1991716644473195_2102760483368810,1,2,0,3,0.3612
1991716644473195_2102820516696140,2,4,0,6,0.8808
1991716644473195_2102845020027023,1,0,0,1,0.4404
1991716644473195_2102954576682734,0,2,0,2,0
1991716644473195_2102957206682471,1,0,0,1,0.636
1991716644473195_2103011073343751,0,5,1,6,-0.4215
1991716644473195_2103045280006997,1,9,0,10,0.4404
1991716644473195_2103078313337027,0,1,0,1,0
1991716644473195_2103078700003655,0,8,0,8,0
1991716644473195_2103080853336773,0,2,0,2,0
1991716644473195_2103172906660901,2,0,1,3,0.3262
1991716644473195_2103216393323219,1,5,0,6,0.3612
1991716644473195_2103246756653516,1,1,0,2,0.2382
1991716644473195_2103247463320112,2,4,0,6,1.2424
1991716644473195_2103255619985963,0,2,1,3,-0.5423
1991716644473195_2103414696636722,0,2,1,3,-0.128
1991716644473195_2103566459954879,0,2,0,2,0
1991716644473195_2103601689951356,0,1,0,1,0
1991716644473195_2103620409949484,1,6,2,9,-0.2007
1991716644473195_2103626943282164,0,5,2,7,-0.6282
1991716644473195_2103681389943386,3,19,1,23,-0.3107
1991716644473195_2103785946599597,2,2,2,6,0.3439
1991716644473195_2103806446597547,0,6,1,7,-0.296
1991716644473195_2103992273245631,1,2,0,3,0.4215
1991716644473195_2104036359907889,1,10,0,11,0.296
1991716644473195_2104050583239800,0,1,0,1,0
1991716644473195_2104085696569622,0,2,0,2,0
1991716644473195_2104095219902003,7,17,1,25,2.4024
1991716644473195_2104105916567600,1,7,1,9,0.2467
1991716644473195_2104106823234176,2,5,0,7,0.7012
1991716644473195_2104115329899992,0,2,0,2,0
1991716644473195_2104268673217991,0,2,0,2,0
1991716644473195_2104307716547420,0,4,0,4,0
1991716644473195_2104565133188345,2,3,0,5,0.636
1991716644473195_2104582743186584,3,13,3,19,-0.2767
1991716644473195_2104637849847740,1,8,0,9,0.296
1991716644473195_2104645073180351,1,3,1,5,-0.1059
1991716644473195_2104693533175505,2,6,1,9,0.3818
1991716644473195_2104715379839987,0,5,0,5,0
1991716644473195_2104718769839648,0,2,0,2,0
1991716644473195_2104725099839015,0,2,0,2,0
1991716644473195_2104732219838303,0,2,0,2,0
1991716644473195_2104781856500006,2,10,0,12,1.177
1991716644473195_2104795239832001,17,8,0,25,8.8258
1991716644473195_2104818523163006,0,5,0,5,0
1991716644473195_2104889176489274,0,1,1,2,-0.5719
1991716644473195_2104893899822135,1,4,1,6,0
1991716644473195_2104901679821357,0,7,1,8,-0.8604
1991716644473195_2105061139805411,1,3,0,4,0.4939
1991716644473195_2105092773135581,0,1,0,1,0
1991716644473195_2105093459802179,0,2,0,2,0
1991716644473195_2105093916468800,0,1,0,1,0
1991716644473195_2105169849794540,0,2,1,3,-0.4404
1991716644473195_2105213093123549,3,5,0,8,1.9484
1991716644473195_2105213176456874,3,0,0,3,1.4608
1991716644473195_2105223579789167,1,1,0,2,0.6808
1991716644473195_2105245969786928,1,0,0,1,0.4019
1991716644473195_2105287149782810,0,3,0,3,0
1991716644473195_2105289819782543,0,4,2,6,-1.7208
1991716644473195_2105697119741813,0,3,2,5,-1.6281
1991716644473195_2105731879738337,1,3,0,4,0.4404
1991716644473195_2105743919737133,0,5,1,6,-0.8604
1991716644473195_2105776239733901,1,1,0,2,0.0772
1991716644473195_2105796693065189,6,2,0,8,2.5472
1991716644473195_2105843839727141,0,4,1,5,-0.296
1991716644473195_2105943236383868,0,1,0,1,0
1991716644473195_2106234829688042,0,1,0,1,0
1991716644473195_2106242739687251,0,1,0,1,0
1991716644473195_2106266396351552,0,4,1,5,-0.8604
1991716644473195_2106322029679322,1,5,0,6,0.34
1991716644473195_2106411953003663,0,2,0,2,0
1991716644473195_2106435966334595,0,4,3,7,-2.0168
1991716644473195_2106436476334544,0,1,0,1,0
1991716644473195_2106440686334123,1,1,0,2,0.2023
1991716644473195_2106460932998765,1,3,0,4,0.2732
1991716644473195_2106477529663772,0,1,0,1,0
1991716644473195_2106719362972922,1,0,0,1,0.296
1991716644473195_2106731766305015,3,4,0,7,1.4053
1991716644473195_2106824246295767,3,4,0,7,0.9738
1991716644473195_2107188472926011,2,2,3,7,-1.1995
1991716644473195_2107189679592557,2,6,2,10,-0.0193
1991716644473195_2107343009577224,0,2,1,3,-0.8604
1991716644473195_2107367752908083,0,3,1,4,-0.8604
1991716644473195_2107426859568839,0,3,0,3,0
1991716644473195_2107634886214703,2,8,1,11,0.2814
1991716644473195_2107651852879673,0,3,0,3,0
1991716644473195_2107658442879014,1,1,0,2,0.34
1991716644473195_2107886512856207,0,2,0,2,0
1991716644473195_2107966782848180,1,2,1,4,-0.3638
1991716644473195_2108006559510869,1,1,0,2,0.296
1991716644473195_2108048119506713,0,2,0,2,0
1991716644473195_2108052252839633,0,1,0,1,0
1991716644473195_2108218562823002,4,1,0,5,2.0517
1991716644473195_2108390072805851,0,1,0,1,0
1991716644473195_2108406112804247,1,3,0,4,0.296
1991716644473195_2108486752796183,0,2,1,3,-0.296
1991716644473195_2108513239460201,1,2,0,3,0.0772
1991716644473195_2108542192790639,0,8,0,8,0
1991716644473195_2108568112788047,0,3,1,4,-0.296
1991716644473195_2108607576117434,1,4,0,5,0.3818
1991716644473195_2108624336115758,0,1,0,1,0
1991716644473195_2108646212780237,5,4,0,9,1.8391
1991716644473195_2108661409445384,1,5,0,6,0.34
1991716644473195_2108670506111141,1,5,0,6,0.6808
1991716644473195_2108685012776357,2,3,0,5,0.8339
1991716644473195_2108690736109118,4,1,0,5,1.5842
1991716644473195_2108930619418463,0,3,0,3,0
1991716644473195_2108984866079705,3,2,0,5,1.1851
1991716644473195_2108989522745906,0,3,0,3,0
1991716644473195_2109003422744516,1,3,0,4,0.0772
1991716644473195_2109021862742672,0,4,1,5,-0.4767
1991716644473195_2109059639405561,2,1,0,3,0.7364
1991716644473195_2109074199404105,4,1,0,5,1.7427
1991716644473195_2109091512735707,1,1,0,2,0.4404
1991716644473195_2109101662734692,0,1,0,1,0
1991716644473195_2109137242731134,4,0,0,4,1.9017
1991716644473195_2109145169397008,2,0,0,2,0.8808
1991716644473195_2109147849396740,0,2,0,2,0
1991716644473195_2109271826051009,0,3,0,3,0
1991716644473195_2109419506036241,1,1,0,2,0.34
1991716644473195_2109439149367610,0,2,0,2,0
1991716644473195_2109493682695490,0,1,1,2,-0.296
1991716644473195_2109512329360292,1,0,0,1,0.4404
1991716644473195_2109555562689302,2,8,0,10,0.9861
1991716644473195_2109557686022423,1,4,1,6,0.044
1991716644473195_2109610502683808,1,3,0,4,0.4404
1991716644473195_2109654912679367,0,1,0,1,0
1991716644473195_2109785562666302,2,0,0,2,0.8619
1991716644473195_2110092709302254,5,2,0,7,2.5386
1991716644473195_2110154682629390,1,0,1,2,0.1506
1991716644473195_2110308032614055,2,2,0,4,0.8679
1991716644473195_2110550412589817,1,2,0,3,0.3182
1991716644473195_2110648465913345,0,5,1,6,-0.0516
1991716644473195_2110716292573229,0,4,0,4,0
1991716644473195_2110744022570456,1,6,1,8,0.3289
1991716644473195_2110792919232233,0,3,0,3,0
1991716644473195_2110832775894914,5,2,0,7,2.2606
1991716644473195_2110876695890522,1,7,0,8,0.4588
1991716644473195_2111181592526699,1,2,0,3,0.0772
1991716644473195_2111250092519849,2,6,1,9,0.9288
1991716644473195_2111251395853052,1,0,0,1,0.2732
1991716644473195_2111335775844614,10,5,0,15,4.9852
1991716644473195_2111382989173226,0,2,0,2,0
1991716644473195_2111618482483010,3,4,0,7,1.6492
1991716644473195_2111662972478561,1,0,0,1,0.4215
1991716644473195_2111681425810049,2,0,0,2,0.843
1991716644473195_2111682635809928,0,5,0,5,0
1991716644473195_2111690409142484,1,0,0,1,0.6369
1991716644473195_2111704755807716,0,0,1,1,-0.0258
1991716644473195_2111721849139340,0,1,0,1,0
1991716644473195_2111736925804499,0,4,0,4,0
1991716644473195_2111745789136946,2,2,1,5,0.0647
1991716644473195_2111766769134848,1,3,1,5,0.4848
1991716644473195_2111769175801274,2,2,0,4,0.6582
1991716644473195_2111795985798593,0,4,0,4,0
1991716644473195_2111802109131314,1,0,0,1,0.4404
1991716644473195_2111846875793504,0,1,0,1,0
1991716644473195_2111874309124094,0,1,0,1,0
1991716644473195_2112037805774411,4,1,0,5,2.0018
1991716644473195_2112059545772237,0,2,0,2,0
1991716644473195_2112078872436971,0,5,0,5,0
1991716644473195_2112079949103530,0,3,0,3,0
1991716644473195_2112110469100478,0,1,1,2,-0.296
1991716644473195_2112126845765507,11,2,0,13,5.2623
1991716644473195_2112127929098732,2,0,0,2,0.843
1991716644473195_2112137225764469,0,1,0,1,0
1991716644473195_2112168735761318,2,0,0,2,0.8808
1991716644473195_2112174695760722,0,2,0,2,0
1991716644473195_2112181012426757,0,0,2,2,-0.727
1991716644473195_2112181689093356,4,0,0,4,1.9794
1991716644473195_2112468212398037,1,3,0,4,0.296
1991716644473195_2112483185729873,0,2,0,2,0
1991716644473195_2112513402393518,0,1,0,1,0
1991716644473195_2112533482391510,0,1,0,1,0
1991716644473195_2112540709057454,0,2,0,2,0
1991716644473195_2112557945722397,2,1,0,3,0.8808
1991716644473195_2112560292388829,1,0,0,1,0.4404
1991716644473195_2112563632388495,1,0,0,1,0.5994
1991716644473195_2112570549054470,0,3,0,3,0
1991716644473195_2112592035718988,1,0,0,1,0.4215
1991716644473195_2112595292385329,2,3,0,5,1.2735
1991716644473195_2112624335715758,0,3,1,4,-0.296
1991716644473195_2112625865715605,0,1,0,1,0
1991716644473195_2112636812381177,1,2,1,4,0.4285
1991716644473195_2112647965713395,1,1,0,2,0.296
1991716644473195_2112663692378489,4,5,0,9,1.4731
1991716644473195_2112678605710331,0,2,0,2,0
1991716644473195_2112749452369913,3,0,0,3,1.2704
1991716644473195_2112753385702853,2,0,0,2,0.8808
1991716644473195_2112754785702713,4,0,0,4,1.7399
1991716644473195_2112932272351631,0,0,1,1,-0.296
1991716644473195_2112934549018070,0,1,0,1,0
1991716644473195_2112967595681432,1,0,0,1,0.5994
1991716644473195_2112986625679529,0,2,0,2,0
1991716644473195_2113013549010170,2,0,0,2,0.9606
1991716644473195_2113030715675120,1,6,1,8,0.4146
1991716644473195_2113080852336773,3,2,0,5,1.2042
1991716644473195_2113109782333880,1,1,0,2,0.5994
1991716644473195_2113130155665176,1,2,0,3,0.5423
1991716644473195_2113134682331390,1,2,0,3,0.296
1991716644473195_2113134742331384,4,0,0,4,1.954
1991716644473195_2113207665657425,0,2,1,3,-0.4019
1991716644473195_2113543612290497,11,1,0,12,5.0983
1991716644473195_2113559048955620,0,4,0,4,0
1991716644473195_2113616662283192,2,9,1,12,0.5848
1991716644473195_2113938208917704,0,3,0,3,0
1991716644473195_2113970302247828,1,2,2,5,-0.773
1991716644473195_2114074545570737,1,5,1,7,0.1491
1991716644473195_2114105888900936,0,0,2,2,-0.592
1991716644473195_2114152725562919,0,2,0,2,0
1991716644473195_2114246435553548,2,6,0,8,0.6142
1991716644473195_2114412978870227,1,6,0,7,0.4215
1991716644473195_2114430655535126,0,3,0,3,0
1991716644473195_2114431812201677,0,2,0,2,0
1991716644473195_2114507658860759,0,1,0,1,0
1991716644473195_2114514612193397,2,2,0,4,0.8619
1991716644473195_2114531988858326,1,0,0,1,0.4215
1991716644473195_2114538005524391,0,3,0,3,0
1991716644473195_2114541422190716,3,4,1,8,0.8987
1991716644473195_2114562785521913,8,3,0,11,3.5043
1991716644473195_2114564492188409,1,0,0,1,0.4404
1991716644473195_2114576028853922,2,4,1,7,0.4864
1991716644473195_2114634045514787,0,3,0,3,0
1991716644473195_2114641705514021,2,0,0,2,0.8619
1991716644473195_2114662892178569,1,0,0,1,0.4215
1991716644473195_2114684322176426,2,0,0,2,0.8969
1991716644473195_2114713225506869,3,0,0,3,1.3546
1991716644473195_2114780385500153,4,0,0,4,1.8894
1991716644473195_2114931315485060,1,1,0,2,0.4404
1991716644473195_2114958355482356,2,0,1,3,0.0772
1991716644473195_2114959385482253,4,1,0,5,1.8639
1991716644473195_2114959438815581,2,0,0,2,1.0464
1991716644473195_2114965052148353,3,2,0,5,1.6979
1991716644473195_2114971162147742,3,0,1,4,1.3504
1991716644473195_2114972805480911,2,2,0,4,0.9649
1991716644473195_2114972832147575,3,0,0,3,1.2645
1991716644473195_2114999515478240,3,1,0,4,1.3023
1991716644473195_2115069675471224,6,0,0,6,2.7483
1991716644473195_2115131052131753,0,1,0,1,0
1991716644473195_2115191122125746,3,3,0,6,1.1639
1991716644473195_2115230592121799,4,0,0,4,2.074
1991716644473195_2115271098784415,9,1,1,11,3.8238
1991716644473195_2115463475431844,0,2,1,3,-0.296
1991716644473195_2115525062092352,4,1,0,5,1.7238
1991716644473195_2115546745423517,0,1,0,1,0
1991716644473195_2115554582089400,4,0,0,4,1.5827
1991716644473195_2115562545421937,0,3,0,3,0
1991716644473195_2115573095420882,2,2,1,5,0.1212
1991716644473195_2115604562084402,2,2,0,4,0.6778
1991716644473195_2115621675416024,0,1,2,3,-0.6959
1991716644473195_2115623878749137,2,0,0,2,0.8619
1991716644473195_2115630695415122,2,3,0,5,0.5635
1991716644473195_2115636855414506,7,1,0,8,3.2415
1991716644473195_2115677822077076,21,3,1,25,9.8029
1991716644473195_2115694978742027,1,3,2,6,-0.1873
1991716644473195_2115719112072947,0,3,0,3,0
1991716644473195_2115746912070167,0,4,0,4,0
1991716644473195_2115755825402609,2,5,0,7,0.7397
1991716644473195_2115989748712550,0,7,0,7,0
1991716644473195_2115996188711906,0,2,0,2,0
1991716644473195_2116015988709926,1,2,0,3,0.4404
1991716644473195_2116030518708473,0,1,0,1,0
1991716644473195_2116051042039754,1,3,1,5,-0.4077
1991716644473195_2116125728698952,1,3,0,4,0.5719
1991716644473195_2116143718697153,0,1,0,1,0
1991716644473195_2116154502029408,18,2,0,20,9.0826
1991716644473195_2116156452029213,19,5,1,25,8.0501
1991716644473195_2116161938695331,1,8,0,9,0.3182
1991716644473195_2116174922027366,3,1,0,4,1.0398
1991716644473195_2116235575354634,0,4,2,6,-0.5553
1991716644473195_2116235745354617,0,5,3,8,-1.2402
1991716644473195_2116243138687211,0,5,4,9,-1.1832
1991716644473195_2116243302020528,5,0,0,5,2.2165
1991716644473195_2116245172020341,0,3,0,3,0
1991716644473195_2116309805347211,3,0,0,3,2.0763
1991716644473195_2116314742013384,0,1,0,1,0
1991716644473195_2116321308679394,0,4,0,4,0
1991716644473195_2116335422011316,1,1,0,2,0.296
1991716644473195_2116500195328172,1,4,3,8,-1.0436
1991716644473195_2116510375327154,0,0,1,1,-0.4019
1991716644473195_2116522001992658,0,2,1,3,-0.5574
1991716644473195_2116528921991966,1,6,0,7,0.6369
1991716644473195_2116529695325222,5,2,0,7,1.7212
1991716644473195_2116554001989458,0,1,0,1,0
1991716644473195_2116588728652652,0,1,0,1,0
1991716644473195_2116599641984894,4,1,0,5,2.109
1991716644473195_2116607958650729,0,4,0,4,0
1991716644473195_2116615778649947,4,0,0,4,1.7427
1991716644473195_2116616825316509,1,13,0,14,0.4019
1991716644473195_2116617088649816,2,2,1,5,1.2475
1991716644473195_2116645081980350,2,0,0,2,0.843
1991716644473195_2116651101979748,0,3,0,3,0
1991716644473195_2116667131978145,5,3,0,8,2.3232
1991716644473195_2116670705311121,0,2,1,3,-0.296
1991716644473195_2116689645309227,2,0,0,2,0.843
1991716644473195_2116713378640187,0,5,0,5,0
1991716644473195_2116725505305641,0,2,0,2,0
1991716644473195_2116726631972195,3,0,1,4,0.9082
1991716644473195_2116774515300740,2,2,0,4,0.7364
1991716644473195_2116781525300039,1,1,0,2,0.296
1991716644473195_2116796925298499,2,0,0,2,0.8808
1991716644473195_2116820775296114,4,1,0,5,1.954
1991716644473195_2116831138628411,2,7,1,10,0.0653
1991716644473195_2116851531959705,3,1,0,4,1.3023
1991716644473195_2116865815291610,0,1,0,1,0
1991716644473195_2116868841957974,0,3,0,3,0
1991716644473195_2116926088618916,2,1,0,3,0.8066
1991716644473195_2117068068604718,0,0,1,1,-0.296
1991716644473195_2117080851936773,1,1,0,2,0.4215
1991716644473195_2117109998600525,1,3,1,5,0
1991716644473195_2117110595267132,0,1,0,1,0
1991716644473195_2117111968600328,3,0,0,3,1.3023
1991716644473195_2117116801933178,2,1,0,3,1.0209
1991716644473195_2117126708598854,0,1,0,1,0
1991716644473195_2117127181932140,2,0,0,2,0.8619
1991716644473195_2117130398598485,2,0,0,2,0.7804
1991716644473195_2117133631931495,0,2,0,2,0
1991716644473195_2117136901931168,6,2,0,8,2.5668
1991716644473195_2117173081927550,0,3,0,3,0
1991716644473195_2117256075252584,6,0,0,6,2.8438
1991716644473195_2117256828585842,1,3,0,4,0.296
1991716644473195_2117276378583887,1,1,0,2,0.3182
1991716644473195_2117307871914071,6,3,0,9,3.0838
1991716644473195_2117317181913140,11,3,0,14,5.5408
1991716644473195_2117317245246467,1,2,0,3,0.4215
1991716644473195_2117326535245538,0,0,2,2,-0.8383
1991716644473195_2117341958577329,5,0,0,5,2.085
1991716644473195_2117352691909589,5,0,0,5,2.1453
1991716644473195_2117398831904975,3,0,0,3,1.2042
1991716644473195_2117399381904920,3,0,0,3,1.3876
1991716644473195_2117415078570017,1,0,0,1,0.4404
1991716644473195_2117456265232565,5,1,0,6,2.1642
1991716644473195_2117457288565796,1,1,0,2,0.5574
1991716644473195_2117463921898466,1,3,0,4,0.4215
1991716644473195_2117464588565066,5,4,1,10,1.8434
1991716644473195_2117485268562998,2,1,0,3,0.8619
1991716644473195_2117490771895781,6,0,0,6,2.9535
1991716644473195_2117502721894586,4,5,0,9,1.3382
1991716644473195_2117763381868520,0,1,0,1,0
1991716644473195_2117823091862549,1,0,0,1,0.4404
1991716644473195_2117866708524854,0,2,2,4,-0.4739
1991716644473195_2117876768523848,0,1,0,1,0
1991716644473195_2117984255179766,0,2,1,3,-0.296
1991716644473195_2118030255175166,0,1,0,1,0
1991716644473195_2118043891840469,13,1,0,14,6.4135
1991716644473195_2118096861835172,2,3,0,5,0.843
1991716644473195_2118102525167939,2,1,0,3,0.4334
1991716644473195_2118139538497571,5,3,0,8,2.1808
1991716644473195_2118368158474709,0,2,1,3,-0.296
1991716644473195_2118440401800818,0,0,1,1,-0.296
1991716644473195_2118489738462551,1,1,1,3,-0.0619
1991716644473195_2118490815129110,2,0,1,3,-0.1672
1991716644473195_2118495035128688,2,0,0,2,0.9681
1991716644473195_2118551495123042,5,2,0,7,2.4483
1991716644473195_2118555211789337,4,3,0,7,2.1219
1991716644473195_2118594235118768,1,2,0,3,0.4215
1991716644473195_2118637735114418,1,3,0,4,0.5732
1991716644473195_2118642005113991,1,3,0,4,0.4588
1991716644473195_2118650125113179,0,4,0,4,0
1991716644473195_2118673848444140,1,3,0,4,0.4404
1991716644473195_2118675301777328,0,4,0,4,0
1991716644473195_2118707331774125,1,1,0,2,0.4215
1991716644473195_2119050288406496,2,3,0,5,0.7419
1991716644473195_2119076845070507,5,0,0,5,2.7687
1991716644473195_2119093485068843,5,1,0,6,2.3865
1991716644473195_2119116581733200,0,5,0,5,0
1991716644473195_2119120425066149,9,3,0,12,4.4038
1991716644473195_2119146248396900,2,7,0,9,0.6572
1991716644473195_2119154151729443,4,1,0,5,2.2172
1991716644473195_2119183401726518,1,0,0,1,0.5994
1991716644473195_2119183858393139,0,1,0,1,0
1991716644473195_2119214065056785,1,0,0,1,0.4215
1991716644473195_2119246171720241,1,3,0,4,0.4215
1991716644473195_2119252038386321,2,0,0,2,0.9331
1991716644473195_2119283141716544,7,0,0,7,3.2768
1991716644473195_2119285741716284,1,1,0,2,0.4404
1991716644473195_2119299195048272,2,1,0,3,1.2243
1991716644473195_2119321658379359,3,1,0,4,1.4478
1991716644473195_2119326581712200,0,3,0,3,0
1991716644473195_2119327458378779,6,0,0,6,3.5874
1991716644473195_2119336378377887,0,1,0,1,0
1991716644473195_2119342125043979,2,5,1,8,0.297
1991716644473195_2119536405024551,0,3,0,3,0
1991716644473195_2119582011686657,0,3,1,4,-0.5423
1991716644473195_2119584545019737,0,1,0,1,0
1991716644473195_2119586221686236,4,11,3,18,1.077
1991716644473195_2119590121685846,1,3,2,6,-0.0814
1991716644473195_2119598828351642,1,0,0,1,0.4404
1991716644473195_2119598965018295,2,13,2,17,0.3423
1991716644473195_2119601731684685,0,1,0,1,0
1991716644473195_2119603048351220,0,8,1,9,-0.4019
1991716644473195_2119604498351075,0,3,0,3,0
1991716644473195_2119605771684281,1,2,0,3,0.296
1991716644473195_2119615071683351,0,14,0,14,0
1991716644473195_2119620191682839,5,0,0,5,2.2704
1991716644473195_2119620268349498,6,2,1,9,2.5354
1991716644473195_2119620865016105,0,1,0,1,0
1991716644473195_2119629535015238,0,1,0,1,0
1991716644473195_2119634241681434,2,3,0,5,1.4365
1991716644473195_2119634815014710,0,1,0,1,0
1991716644473195_2119636638347861,2,0,0,2,0.9854
1991716644473195_2119644811680377,0,3,2,5,-0.6282
1991716644473195_2119645435013648,1,5,0,6,0.0772
1991716644473195_2119646288346896,0,1,0,1,0
1991716644473195_2119735745004617,0,1,0,1,0
1991716644473195_2119741738337351,0,1,0,1,0
1991716644473195_2119765268334998,1,3,0,4,0.7964
1991716644473195_2119768555001336,0,3,0,3,0
1991716644473195_2119772358334289,1,1,0,2,0.296
1991716644473195_2119773198334205,1,0,1,2,-0.1052
1991716644473195_2119775078334017,1,0,0,1,0.4927
1991716644473195_2119790901665768,0,2,0,2,0
1991716644473195_2119838148327710,0,1,0,1,0
1991716644473195_2119848418326683,5,1,0,6,2.838
1991716644473195_2119876108323914,2,2,0,4,0.9972
1991716644473195_2119879271656931,1,2,0,3,0.296
1991716644473195_2119888468322678,0,2,0,2,0
1991716644473195_2119890891655769,2,1,0,3,0.68
1991716644473195_2119897598321765,0,4,0,4,0
1991716644473195_2119913094986882,1,3,0,4,0.2732
1991716644473195_2119943138317211,0,4,1,5,-0.296
1991716644473195_2120084408303084,0,1,0,1,0
1991716644473195_2120129884965203,1,1,0,2,0.3612
1991716644473195_2120131018298423,0,2,0,2,0
1991716644473195_2120138798297645,1,8,1,10,0.1444
1991716644473195_2120148431630015,1,1,0,2,0.5267
1991716644473195_2120153344962857,1,8,3,12,-0.8087
1991716644473195_2120161598295365,0,3,0,3,0
1991716644473195_2120169178294607,6,1,0,7,2.8867
1991716644473195_2120170778294447,0,1,0,1,0
1991716644473195_2120184198293105,0,1,0,1,0
1991716644473195_2120191158292409,0,1,0,1,0
1991716644473195_2120193454958846,4,2,0,6,1.8036
1991716644473195_2120194698292055,0,22,3,25,-1.5952
1991716644473195_2120195198292005,2,0,0,2,1.3644
1991716644473195_2120202724957919,3,0,0,3,1.8048
1991716644473195_2120219764956215,1,6,2,9,0.0582
1991716644473195_2120272284950963,4,0,0,4,1.9858
1991716644473195_2120291814949010,1,2,0,3,0.3612
1991716644473195_2120314104946781,0,2,0,2,0
1991716644473195_2120324714945720,1,2,0,3,0.296
1991716644473195_2120336881611170,3,5,0,8,0.4944
1991716644473195_2120348241610034,1,0,0,1,0.4215
1991716644473195_2120353131609545,0,8,0,8,0
1991716644473195_2120360974942094,8,2,1,11,4.5025
1991716644473195_2120403044937887,0,1,0,1,0
1991716644473195_2120418278269697,0,1,0,1,0
1991716644473195_2120435984934593,1,0,0,1,0.4404
1991716644473195_2120444581600400,0,1,0,1,0
1991716644473195_2120446398266885,1,1,0,2,0.4404
1991716644473195_2120449531599905,0,2,0,2,0
1991716644473195_2120458984932293,0,1,0,1,0
1991716644473195_2120464138265111,0,4,0,4,0
1991716644473195_2120479834930208,1,3,0,4,0.6249
1991716644473195_2120514131593445,1,0,0,1,0.765
1991716644473195_2120597778251747,1,3,0,4,0.6249
1991716644473195_2120611924916999,0,2,0,2,0
1991716644473195_2120730591571799,1,0,0,1,0.5267
1991716644473195_2120731204905071,3,1,0,4,1.5177
1991716644473195_2120875264890665,2,0,0,2,0.7838
1991716644473195_2120877801557078,0,1,0,1,0
1991716644473195_2120886238222901,1,0,0,1,0.2023
1991716644473195_2120890544889137,0,1,0,1,0
1991716644473195_2120927181552140,13,3,0,16,6.4972
1991716644473195_2120934701551388,0,3,0,3,0
1991716644473195_2120938114884380,1,3,2,6,-0.3292
1991716644473195_2120938544884337,1,0,0,1,0.6597
1991716644473195_2120940588217466,1,2,0,3,0.6249
1991716644473195_2120950058216519,4,2,0,6,2.7866
1991716644473195_2120954561549402,0,1,1,2,-0.3612
1991716644473195_2120958164882375,2,0,0,2,1.2917
1991716644473195_2120979141546944,0,1,0,1,0
1991716644473195_2120992468212278,1,1,0,2,0.765
1991716644473195_2120997494878442,2,5,0,7,1.0534
1991716644473195_2120998101545048,0,3,0,3,0
1991716644473195_2121027024875489,0,6,0,6,0
1991716644473195_2121044908207034,1,0,0,1,0.34
1991716644473195_2121057668205758,3,1,0,4,1.0819
1991716644473195_2121057871539071,1,1,0,2,0.34
1991716644473195_2121086608202864,1,0,0,1,0.636
1991716644473195_2121093558202169,1,0,0,1,0.5267
1991716644473195_2121095021535356,1,0,0,1,0.5267
1991716644473195_2121116984866493,2,0,0,2,1.401
1991716644473195_2121119211532937,1,3,1,5,0.1087
1991716644473195_2121138748197650,1,0,0,1,0.765
1991716644473195_2121154194862772,1,1,0,2,0.765
1991716644473195_2121176854860506,1,0,0,1,0.765
1991716644473195_2121180008193524,0,1,0,1,0
1991716644473195_2121187334859458,2,0,2,4,0.3366
1991716644473195_2121219174856274,0,2,0,2,0
1991716644473195_2121226758188849,1,2,0,3,0.5994
1991716644473195_2121238354854356,1,0,0,1,0.765
1991716644473195_2121392604838931,2,0,0,2,0.843
1991716644473195_2121420021502856,0,1,0,1,0
1991716644473195_2121431694835022,0,2,0,2,0
1991716644473195_2121450814833110,1,2,0,3,0.4404
1991716644473195_2121451584833033,0,1,0,1,0
1991716644473195_2121531714825020,1,1,1,3,0
1991716644473195_2121534904824701,0,0,1,1,-0.5423
1991716644473195_2121547374823454,1,2,0,3,0.6249
1991716644473195_2121548391490019,0,1,0,1,0
1991716644473195_2121571501487708,1,2,0,3,0.296
1991716644473195_2121578958153629,1,1,0,2,0.5719
1991716644473195_2121580624820129,1,0,0,1,0.5267
1991716644473195_2121583298153195,1,1,0,2,0.34
1991716644473195_2121584964819695,0,3,1,4,-0.296
1991716644473195_2121589044819287,0,1,0,1,0
1991716644473195_2121623528149172,0,2,0,2,0
1991716644473195_2121624198149105,5,9,0,14,1.9476
1991716644473195_2121626318148893,2,1,0,3,0.9142
1991716644473195_2121645271480331,0,2,0,2,0
1991716644473195_2121750204803171,1,2,0,3,0.3612
1991716644473195_2121757481469110,1,0,0,1,0.765
1991716644473195_2121777551467103,0,2,1,3,-0.4019
1991716644473195_2121779501466908,0,2,2,4,-0.7175
1991716644473195_2121817158129809,20,1,0,21,9.5051
1991716644473195_2122042878107237,3,3,0,6,1.2834
1991716644473195_2122059578105567,4,1,0,5,2.0444
1991716644473195_2122065288104996,0,2,0,2,0
1991716644473195_2122065571438301,6,1,3,10,0.0261
1991716644473195_2122067564771435,10,0,0,10,4.3953
1991716644473195_2122076428103882,1,1,0,2,0.3412
1991716644473195_2122089364769255,0,3,0,3,0
1991716644473195_2122184818093043,1,2,0,3,0.5719
1991716644473195_2122204578091067,0,3,1,4,-0.296
1991716644473195_2122216941423164,1,1,0,2,0.6249
1991716644473195_2122237988087726,0,0,1,1,-0.296
1991716644473195_2122283578083167,1,0,0,1,0.4215
1991716644473195_2122286711416187,2,1,1,4,0.296
1991716644473195_2122334144744777,1,2,0,3,0.1531
1991716644473195_2122337294744462,0,4,1,5,-0.4019
1991716644473195_2122341258077399,10,1,0,11,4.8532
1991716644473195_2122357714742420,1,2,0,3,0.4404
1991716644473195_2122538008057724,0,2,0,2,0
1991716644473195_2122547144723477,3,4,0,7,2.1333
1991716644473195_2122578794720312,2,4,0,6,0.5176
1991716644473195_2122586788052846,0,2,0,2,0
1991716644473195_2122586964719495,3,0,0,3,1.7031
1991716644473195_2122608348050690,0,3,2,5,-0.592
1991716644473195_2122664704711721,2,0,0,2,1.3777
1991716644473195_2122676008043924,1,1,0,2,0.1027
1991716644473195_2122677604710431,0,1,0,1,0
1991716644473195_2122683231376535,0,1,0,1,0
1991716644473195_2122703108041214,3,5,1,9,0.9364
1991716644473195_2122734971371361,0,1,1,2,-0.296
1991716644473195_2122759298035595,1,6,1,8,0.2614
1991716644473195_2122798634698328,4,0,0,4,2.0519
1991716644473195_2122834581361400,1,2,0,3,0.6249
1991716644473195_2123098048001720,1,3,0,4,0.4404
1991716644473195_2123103548001170,1,4,0,5,0.5106
1991716644473195_2123104778001047,0,1,0,1,0
1991716644473195_2123109838000541,1,5,0,6,0.4404
1991716644473195_2123159157995609,3,2,0,5,1.0819
1991716644473195_2123173011327557,0,3,0,3,0
1991716644473195_2123223174655874,3,4,0,7,1.1438
1991716644473195_2123269767984548,1,3,0,4,0.765
1991716644473195_2123270104651181,2,3,0,5,1.0613
1991716644473195_2123283774649814,1,2,0,3,0.3612
1991716644473195_2123322621312596,0,1,0,1,0
1991716644473195_2123336891311169,0,2,0,2,0
1991716644473195_2123347647976760,2,2,0,4,0.7586
1991716644473195_2123356147975910,0,2,1,3,-0.296
1991716644473195_2123566087954916,0,1,0,1,0
1991716644473195_2123606137950911,0,2,0,2,0
1991716644473195_2123609011283957,2,0,0,2,0.8718
1991716644473195_2123636284614563,0,3,1,4,-0.296
1991716644473195_2123637147947810,0,1,0,1,0
1991716644473195_2123638097947715,4,4,1,9,1.4864
1991716644473195_2123642481280610,0,2,0,2,0
1991716644473195_2123645434613648,0,2,0,2,0
1991716644473195_2123654937946031,1,0,0,1,0.765
1991716644473195_2123663894611802,0,1,0,1,0
1991716644473195_2123672687944256,3,4,0,7,1.0601
1991716644473195_2123802764597915,6,6,2,14,1.3812
1991716644473195_2123870547924470,1,6,0,7,0.4215
1991716644473195_2123879121256946,1,0,1,2,0.0858
1991716644473195_2123894247922100,1,2,0,3,0.296
1991716644473195_2124322161212642,0,0,1,1,-0.296
1991716644473195_2124450667866458,0,6,0,6,0
1991716644473195_2124722517839273,2,1,0,3,0.8679
1991716644473195_2124773037834221,0,1,0,1,0
1991716644473195_2124777637833761,1,7,2,10,-0.3173
1991716644473195_2124792104498981,0,2,0,2,0
1991716644473195_2124822634495928,2,3,0,5,0.6639
1991716644473195_2124848897826635,0,1,0,1,0
1991716644473195_2124871637824361,0,1,0,1,0
1991716644473195_2124965604481631,0,0,1,1,-0.296
1991716644473195_2125027487808776,0,0,1,1,-0.296
1991716644473195_2125036067807918,1,1,1,3,-0.4651
1991716644473195_2125120294466162,0,1,0,1,0
1991716644473195_2125300997781425,4,2,0,6,1.3894
1991716644473195_2125413614436830,0,2,0,2,0
1991716644473195_2125457321099126,1,1,0,2,0.5994
1991716644473195_2125473901097468,0,2,0,2,0
1991716644473195_2125479391096919,3,1,0,4,1.7982
1991716644473195_2125494644428727,0,5,1,6,-0.4466
1991716644473195_2125540421090816,0,2,0,2,0
1991716644473195_2125567821088076,4,0,0,4,1.7427
1991716644473195_2125629361081922,7,5,0,12,2.9942
1991716644473195_2125633061081552,0,3,0,3,0
1991716644473195_2125644614413730,0,0,1,1,-0.296
1991716644473195_2125655254412666,2,3,0,5,1.2375
1991716644473195_2125657684412423,5,0,0,5,2.8884
1991716644473195_2125699974408194,1,0,0,1,0.3412
1991716644473195_2125737584404433,0,1,0,1,0
1991716644473195_2125762574401934,1,1,1,3,-0.0697
1991716644473195_2125910104387181,1,1,1,3,0.1137
1991716644473195_2125918957719629,6,4,0,10,2.914
1991716644473195_2125938987717626,1,3,0,4,0.5267
1991716644473195_2125990077712517,1,1,0,2,0.296
1991716644473195_2126009474377244,0,2,0,2,0
1991716644473195_2126020921042766,6,1,0,7,2.6039
1991716644473195_2126021427709382,2,4,1,7,0.6434
1991716644473195_2126024344375757,0,1,0,1,0
1991716644473195_2126049494373242,3,0,1,4,0.8244
1991716644473195_2126052597706265,1,3,0,4,0.5994
1991716644473195_2126071484371043,0,1,0,1,0
1991716644473195_2126104721034386,2,2,0,4,0.7804
1991716644473195_2126106924367499,1,1,0,2,0.5994
1991716644473195_2126157437695781,0,2,0,2,0
1991716644473195_2126165784361613,0,3,0,3,0
1991716644473195_2126274757684049,2,0,0,2,1.3828
1991716644473195_2126292104348981,5,5,3,13,0.8272
1991716644473195_2126446041000254,1,1,0,2,0.6697
1991716644473195_2126456757665849,0,1,0,1,0
1991716644473195_2126468687664656,1,1,1,3,-0.2702
1991716644473195_2126470394331152,0,1,0,1,0
1991716644473195_2126511340993724,8,0,0,8,3.7324
1991716644473195_2126544744323717,3,1,0,4,1.7114
1991716644473195_2126567790988079,0,1,0,1,0
1991716644473195_2126574900987368,0,1,0,1,0
1991716644473195_2126575700987288,1,0,0,1,0.5994
1991716644473195_2126578480987010,8,3,0,11,4.0495
1991716644473195_2126579414320250,0,1,0,1,0
1991716644473195_2126580450986813,1,1,0,2,0.34
1991716644473195_2126584294319762,3,0,0,3,1.1557
1991716644473195_2126588047652720,1,1,0,2,0.3612
1991716644473195_2126610834317108,0,1,0,1,0
1991716644473195_2126619187649606,1,0,0,1,0.5267
1991716644473195_2126641814314010,2,5,0,7,1.2753
1991716644473195_2126649497646575,5,1,0,6,2.9504
1991716644473195_2126653594312832,13,0,0,13,6.0253
1991716644473195_2126671010977757,1,0,0,1,0.6124
1991716644473195_2126678277643697,0,3,0,3,0
1991716644473195_2126680424310149,1,2,0,3,0.296
1991716644473195_2126682830976575,1,1,0,2,0.7034
1991716644473195_2126683547643170,0,0,1,1,-0.296
1991716644473195_2126709680973890,1,0,0,1,0.7269
1991716644473195_2126712117640313,2,0,0,2,0.8969
1991716644473195_2126734647638060,10,2,0,12,4.6833
1991716644473195_2126744727637052,0,1,0,1,0
1991716644473195_2126783244299867,0,2,1,3,-0.296
1991716644473195_2126783354299856,1,4,4,9,-0.4216
1991716644473195_2126785614299630,9,4,0,13,4.5066
1991716644473195_2126788740965984,20,4,0,24,10.9186
1991716644473195_2126807820964076,1,0,0,1,0.765
1991716644473195_2126808217630703,12,5,0,17,6.2341
1991716644473195_2126815114296680,1,2,0,3,0.5719
1991716644473195_2126818440963014,6,1,0,7,2.9668
1991716644473195_2126834334294758,0,2,0,2,0
1991716644473195_2126990407612484,2,4,0,6,1.06
1991716644473195_2127005007611024,2,1,0,3,0.8619
1991716644473195_2127037860941072,5,0,0,5,2.2876
1991716644473195_2127063537605171,0,2,1,3,-0.296
1991716644473195_2127087480936110,2,0,0,2,0.8619
1991716644473195_2127093024268889,1,0,0,1,0.4215
1991716644473195_2127106277600897,0,1,0,1,0
1991716644473195_2127108407600684,0,4,0,4,0
1991716644473195_2127114117600113,6,0,0,6,2.6909
1991716644473195_2127115850933273,3,1,0,4,1.4068
1991716644473195_2127116577599867,5,1,0,6,2.1453
1991716644473195_2127134854264706,12,0,0,12,5.3171
1991716644473195_2127137030931155,1,0,2,3,0.0074
1991716644473195_2127145627596962,4,0,0,4,1.7761
1991716644473195_2127169910927867,1,1,0,2,0.296
1991716644473195_2127207334257458,0,3,0,3,0
1991716644473195_2127248527586672,1,2,0,3,0.4215
1991716644473195_2127259837585541,2,0,0,2,1.092
1991716644473195_2127295357581989,4,1,0,5,1.776
1991716644473195_2127310864247105,3,3,0,6,1.3356
1991716644473195_2127320177579507,4,0,0,4,1.7427
1991716644473195_2127336880911170,1,0,0,1,0.3612
1991716644473195_2127338420911016,1,0,0,1,0.4927
1991716644473195_2127348794243312,5,0,0,5,2.659
1991716644473195_2127350190909839,6,2,0,8,2.7729
1991716644473195_2127362904241901,8,1,0,9,3.5521
1991716644473195_2127539710890887,1,1,0,2,0.5994
1991716644473195_2127541817557343,7,0,0,7,3.6064
1991716644473195_2127543534223838,1,3,0,4,0.5719
1991716644473195_2127562224221969,0,1,0,1,0
1991716644473195_2127577424220449,1,3,0,4,0.296
1991716644473195_2127598304218361,2,0,0,2,1.2326
1991716644473195_2127602590884599,5,0,0,5,2.4009
1991716644473195_2127602987551226,2,1,0,3,0.7636
1991716644473195_2127606537550871,1,1,1,3,-0.2319
1991716644473195_2127611987550326,0,1,0,1,0
1991716644473195_2127614114216780,1,4,1,6,0
1991716644473195_2127630087548516,1,1,0,2,0.0772
1991716644473195_2127638904214301,0,1,0,1,0
1991716644473195_2127642454213946,1,0,2,3,-0.0766
1991716644473195_2127650264213165,7,0,0,7,3.3098
1991716644473195_2127650324213159,0,0,1,1,-0.296
1991716644473195_2127669757544549,1,2,0,3,0.4215
1991716644473195_2127724657539059,1,0,0,1,0.4926
1991716644473195_2127787887532736,1,1,2,4,-0.0814
1991716644473195_2127820500862808,2,0,3,5,0.3005
1991716644473195_2127827280862130,1,2,0,3,0.296
1991716644473195_2127832790861579,6,0,0,6,3.002
1991716644473195_2127833700861488,0,4,0,4,0
1991716644473195_2127846314193560,0,1,0,1,0
1991716644473195_2127848087526716,0,2,1,3,-0.4019
1991716644473195_2127879974190194,0,3,1,4,-0.5267
1991716644473195_2127888657522659,1,1,0,2,0.4927
1991716644473195_2127890220855836,5,1,0,6,2.3232
1991716644473195_2127892534188938,1,3,0,4,0.296
1991716644473195_2127900377521487,2,2,3,7,0.4232
1991716644473195_2127941420850716,2,1,0,3,0.9141
1991716644473195_2127941560850702,7,2,0,9,3.9426
1991716644473195_2127943044183887,1,3,0,4,0.4466
1991716644473195_2127957197515805,0,3,0,3,0
1991716644473195_2127970227514502,2,2,0,4,0.9141
1991716644473195_2127974500847408,0,1,0,1,0
1991716644473195_2127983734179818,0,1,0,1,0
1991716644473195_2128039800840878,5,0,0,5,2.4721
1991716644473195_2128161510828707,6,0,0,6,2.6276
1991716644473195_2128170764161115,3,1,0,4,1.242
1991716644473195_2128204197491105,2,3,0,5,0.8326
1991716644473195_2128204587491066,0,3,0,3,0
1991716644473195_2128227004155491,1,6,5,12,-2.0143
1991716644473195_2128233000821558,1,4,0,5,0.0772
1991716644473195_2128239810820877,1,2,0,3,0.0258
1991716644473195_2128263024151889,2,1,0,3,0.8033
1991716644473195_2128307470814111,5,0,0,5,2.5008
1991716644473195_2128308097480715,18,1,0,19,8.92
1991716644473195_2128311180813740,1,0,0,1,0.6705
1991716644473195_2128321857479339,0,1,0,1,0
1991716644473195_2128327840812074,0,1,1,2,-0.296
1991716644473195_2128328237478701,5,0,0,5,2.2164
1991716644473195_2128349740809884,7,1,0,8,3.0152
1991716644473195_2128361630808695,0,3,0,3,0
1991716644473195_2128385424139649,1,8,3,12,-0.592
1991716644473195_2128387897472735,1,0,0,1,0.296
1991716644473195_2128399957471529,0,2,0,2,0
1991716644473195_2128407790804079,0,1,0,1,0
1991716644473195_2128425464135645,4,13,0,17,2.0846
1991716644473195_2128477870797071,0,1,0,1,0
1991716644473195_2128498017461723,7,3,0,10,3.4235
1991716644473195_2128510834127108,4,0,0,4,1.8299
1991716644473195_2128647590780099,0,2,1,3,-0.296
1991716644473195_2128665857444939,7,3,0,10,3.8045
1991716644473195_2128666377444887,4,1,0,5,1.7399
1991716644473195_2128684530776405,2,0,0,2,0.9141
1991716644473195_2128734034104788,0,2,0,2,0
1991716644473195_2128747780770080,1,0,0,1,0.4926
1991716644473195_2128754530769405,1,3,0,4,0.296
1991716644473195_2128991000745758,2,4,0,6,0.8066
1991716644473195_2128996557411869,5,2,0,7,2.5178
1991716644473195_2129010784077113,1,1,0,2,0.5719
1991716644473195_2129287820716076,0,1,0,1,0
1991716644473195_2129302827381242,0,0,1,1,-0.2263
1991716644473195_2129327174045474,3,1,0,4,1.4424
1991716644473195_2129436900701168,1,3,1,5,0
1991716644473195_2129635470681311,0,1,2,3,-0.592
1991716644473195_2129672430677615,1,22,2,25,-0.3797
1991716644473195_2129952953982896,0,1,0,1,0
1991716644473195_2129959480648910,0,2,0,2,0
1991716644473195_2130043250640533,20,5,0,25,9.5737
1991716644473195_2130097590635099,2,6,0,8,0.8108
1991716644473195_2130099780634880,0,6,0,6,0
1991716644473195_2130232303954961,1,4,0,5,0.296
1991716644473195_2130253113952880,2,2,2,6,0.3411
1991716644473195_2130256600619198,0,1,0,1,0
1991716644473195_2130258127285712,6,0,0,6,2.6235
1991716644473195_2130425550602303,1,0,0,1,0.4215
1991716644473195_2130456773932514,4,10,0,14,1.5619
1991716644473195_2130482630596595,0,4,1,5,-0.5423
1991716644473195_2130501990594659,0,9,0,9,0
1991716644473195_2130519573926234,7,0,0,7,3.2818
1991716644473195_2130523497259175,1,3,4,8,-0.9532
1991716644473195_2130529743925217,1,8,1,10,-0.0619
1991716644473195_2130551363923055,1,10,0,11,0.296
1991716644473195_2130560630588795,1,3,0,4,0.5106
1991716644473195_2130570733921118,0,3,2,5,-0.8954
1991716644473195_2130576687253856,0,1,0,1,0
1991716644473195_2130577150587143,1,4,0,5,0.4019
1991716644473195_2130586630586195,5,0,0,5,2.1992
1991716644473195_2130623570582501,4,0,0,4,1.9915
1991716644473195_2130641627247362,1,3,0,4,0.296
1991716644473195_2130655843912607,0,8,1,9,-0.4019
1991716644473195_2130662130578645,5,0,0,5,2.3676
1991716644473195_2130705403907651,1,1,0,2,0.4215
1991716644473195_2130712003906991,23,2,0,25,10.9119
1991716644473195_2130716570573201,0,5,1,6,-0.296
1991716644473195_2130720123906179,1,4,0,5,0.296
1991716644473195_2130739000570958,0,2,0,2,0
1991716644473195_2130740853904106,0,4,0,4,0
1991716644473195_2130776173900574,1,0,0,1,0.4404
1991716644473195_2130786650566193,11,2,0,13,4.6835
1991716644473195_2130792353898956,0,1,0,1,0
1991716644473195_2130799897231535,2,3,1,6,0.535
1991716644473195_2130807747230750,0,3,0,3,0
1991716644473195_2130863783891813,9,2,0,11,4.1517
1991716644473195_2130957650549093,1,4,0,5,0.7034
1991716644473195_2131014350543423,1,1,0,2,0.4215
1991716644473195_2131015040543354,0,2,0,2,0
1991716644473195_2131016603876531,0,5,0,5,0
1991716644473195_2131017037209821,7,14,4,25,1.6213
1991716644473195_2131017943876397,2,2,0,4,0.8808
1991716644473195_2131020480542810,1,1,0,2,0.296
1991716644473195_2131027863875405,0,3,0,3,0
1991716644473195_2131030953875096,0,1,0,1,0
1991716644473195_2131033383874853,3,1,0,4,1.3212
1991716644473195_2131093137202211,1,4,0,5,0.4404
1991716644473195_2131097173868474,4,1,0,5,1.8127
1991716644473195_2131110103867181,0,1,0,1,0
1991716644473195_2131110773867114,4,0,0,4,1.9071
1991716644473195_2131111007200424,13,2,0,15,5.7221
1991716644473195_2131112487200276,3,1,0,4,1.2834
1991716644473195_2131112897200235,1,3,0,4,0.4019
1991716644473195_2131116113866580,0,4,0,4,0
1991716644473195_2131122607199264,21,4,0,25,11.7537
1991716644473195_2131125513865640,5,2,0,7,2.2181
1991716644473195_2131142903863901,1,1,0,2,0.25
1991716644473195_2131157750529083,1,3,0,4,0.5106
1991716644473195_2131157810529077,2,2,0,4,0.9671
1991716644473195_2131164853861706,0,2,1,3,-0.296
1991716644473195_2131166223861569,0,2,1,3,-0.296
1991716644473195_2131221297189395,1,1,0,2,0.5994
1991716644473195_2131231380521720,0,2,1,3,-0.4019
1991716644473195_2131231707188354,0,3,2,5,-0.592
1991716644473195_2131245873853604,0,4,0,4,0
1991716644473195_2131255883852603,0,2,0,2,0
1991716644473195_2131261387185386,0,1,0,1,0
1991716644473195_2131278720516986,2,3,1,6,0.5106
1991716644473195_2131280863850105,2,5,0,7,0.7838
1991716644473195_2131294760515382,0,3,0,3,0
1991716644473195_2131306513847540,0,1,0,1,0
1991716644473195_2131332593844932,2,6,0,8,0.5663
1991716644473195_2131352500509608,1,0,0,1,0.5994
1991716644473195_2131365347174990,1,1,1,3,0.2899
1991716644473195_2131498677161657,2,0,0,2,0.8619
1991716644473195_2131523420492516,2,2,1,5,0.3345
1991716644473195_2131560033822188,0,3,0,3,0
1991716644473195_2131566440488214,5,1,0,6,1.8298
1991716644473195_2131569923821199,2,0,0,2,1.0398
1991716644473195_2131570403821151,1,0,0,1,0.34
1991716644473195_2131574367154088,4,13,5,22,-0.1652
1991716644473195_2131575790487279,0,1,0,1,0
1991716644473195_2131577977153727,1,0,0,1,0.5994
1991716644473195_2131578607153664,0,1,0,1,0
1991716644473195_2131583327153192,0,2,0,2,0
1991716644473195_2131587347152790,2,0,0,2,0.8619
1991716644473195_2131616800483178,1,0,0,1,0.4215
1991716644473195_2131618237149701,2,2,0,4,0.8808
1991716644473195_2131622647149260,0,4,0,4,0
1991716644473195_2131635673814624,2,0,0,2,0.8808
1991716644473195_2131635943814597,1,0,0,1,0.4404
1991716644473195_2131648367146688,1,6,0,7,0.296
1991716644473195_2131680150476843,0,2,0,2,0
1991716644473195_2131704040474454,17,8,0,25,8.1892
1991716644473195_2131799337131591,0,1,0,1,0
1991716644473195_2131814620463396,1,0,0,1,0.3612
1991716644473195_2131816173796574,3,1,1,5,0.6441
1991716644473195_2131816420463216,1,0,0,1,0.5473
1991716644473195_2131837207127804,1,0,0,1,0.7579
1991716644473195_2131848090460049,7,3,0,10,3.2921
1991716644473195_2132085637102961,1,0,0,1,0.5583
1991716644473195_2132087083769483,0,6,2,8,-0.6979
1991716644473195_2132112190433639,0,1,0,1,0
1991716644473195_2132117523766439,0,1,1,2,-0.4019
1991716644473195_2132145133763678,8,16,1,25,3.5815
1991716644473195_2132146870430171,10,2,0,12,3.9288
1991716644473195_2132148343763357,1,1,0,2,0.34
1991716644473195_2132155987095926,0,2,0,2,0
1991716644473195_2132160190428839,1,1,0,2,0.296
1991716644473195_2132165827094942,1,4,0,5,0.1779
1991716644473195_2132168337094691,1,3,2,6,-0.4141
1991716644473195_2132173593760832,1,1,0,2,0.1779
1991716644473195_2132184260426432,1,0,0,1,0.5859
1991716644473195_2132266800418178,1,1,0,2,0.4404
1991716644473195_2132345993743592,0,1,0,1,0
1991716644473195_2132375743740617,2,1,0,3,1.0209
1991716644473195_2132432763734915,5,0,0,5,2.3232
1991716644473195_2132492740395584,1,0,0,1,0.4404
1991716644473195_2132509303727261,1,1,0,2,0.1779
1991716644473195_2132705997040925,0,1,0,1,0
1991716644473195_2132710547040470,3,0,0,3,1.4802
1991716644473195_2132714697040055,0,2,2,4,-0.4739
1991716644473195_2132719027039622,2,2,0,4,0.4511
1991716644473195_2132758863702305,2,0,0,2,0.8619
1991716644473195_2132778783700313,2,1,0,3,0.8969
1991716644473195_2132786870366171,1,2,0,3,0.1779
1991716644473195_2132787207032804,0,0,1,1,-0.296
1991716644473195_2132813917030133,0,2,0,2,0
1991716644473195_2132823823695809,1,0,0,1,0.7783
1991716644473195_2132842820360576,1,3,0,4,0.0772
1991716644473195_2132869463691245,0,1,0,1,0
1991716644473195_2132871817024343,2,0,0,2,0.8619
1991716644473195_2132910933687098,0,0,1,1,-0.296
1991716644473195_2132933070351551,6,0,0,6,3.584
1991716644473195_2132970057014519,0,2,0,2,0
1991716644473195_2133007517010773,0,1,0,1,0
1991716644473195_2133024540342404,0,2,0,2,0
1991716644473195_2133032970341561,2,1,0,3,0.8016
1991716644473195_2133080593670132,1,1,0,2,0.34
1991716644473195_2133271906984334,1,0,0,1,0.4215
1991716644473195_2133331283645063,0,1,0,1,0
1991716644473195_2133348310310027,0,1,0,1,0
1991716644473195_2133429960301862,1,0,0,1,0.5994
1991716644473195_2133446670300191,6,5,0,11,3.1326
1991716644473195_2133526110292247,0,2,1,3,-0.296
1991716644473195_2133542256957299,0,3,1,4,-0.4019
1991716644473195_2133582823619909,1,2,0,3,0.3818
1991716644473195_2133596780285180,3,0,0,3,1.6498
1991716644473195_2133596866951838,0,3,0,3,0
1991716644473195_2133607553617436,2,4,1,7,0.0153
1991716644473195_2133620693616122,3,1,0,4,1.2432
1991716644473195_2133649000279958,0,5,3,8,-0.1548
1991716644473195_2133659213612270,2,2,0,4,0.8619
1991716644473195_2133685600276298,2,0,0,2,1.0464
1991716644473195_2133721443606047,0,4,0,4,0
1991716644473195_2133986083579583,6,1,0,7,2.6844
1991716644473195_2134019663576225,0,4,0,4,0
1991716644473195_2134038120241046,0,1,0,1,0
1991716644473195_2134039390240919,0,0,2,2,-0.6979
1991716644473195_2134039630240895,0,4,0,4,0
1991716644473195_2134050643573127,0,2,0,2,0
1991716644473195_2134051546906370,1,0,1,2,0.2146
1991716644473195_2134165050228353,1,5,0,6,0.4939
1991716644473195_2134167176894807,3,15,0,18,2.0089
1991716644473195_2134182576893267,4,0,0,4,1.7049
1991716644473195_2134215810223277,0,8,0,8,0
1991716644473195_2134223346889190,0,2,1,3,-0.296
1991716644473195_2134272863550905,0,3,0,3,0
1991716644473195_2134275780217280,0,1,0,1,0
1991716644473195_2134309930213865,3,0,0,3,1.9281
1991716644473195_2134329050211953,0,4,3,7,-1.3322
1991716644473195_2134350130209845,2,7,1,10,0.0366
1991716644473195_2134354916876033,2,0,0,2,0.9158
1991716644473195_2134404070204451,0,1,0,1,0
1991716644473195_2134560630188795,0,1,0,1,0
1991716644473195_2134584160186442,0,2,0,2,0
1991716644473195_2134590046852520,0,0,1,1,-0.4019
1991716644473195_2134609856850539,2,0,0,2,0.8808
1991716644473195_2134614873516704,4,1,0,5,1.8662
1991716644473195_2134620680182790,3,2,0,5,1.4802
1991716644473195_2134623810182477,0,1,0,1,0
1991716644473195_2134669580177900,5,0,0,5,2.361
1991716644473195_2134693923508799,1,3,0,4,0.296
1991716644473195_2134722133505978,1,3,0,4,0.34
1991716644473195_2134739103504281,0,2,0,2,0
1991716644473195_2134848133493378,0,1,0,1,0
1991716644473195_2134876546823870,5,0,0,5,2.5011
1991716644473195_2134912186820306,0,4,2,6,-0.9171
1991716644473195_2134961510148707,2,2,1,5,0.0767
1991716644473195_2135083123469879,0,2,0,2,0
1991716644473195_2135176303460561,0,2,1,3,-0.4019
1991716644473195_2135196583458533,1,0,0,1,0.4404
1991716644473195_2135243476787177,1,6,0,7,0.3612
1991716644473195_2135423623435829,0,1,0,1,0
1991716644473195_2135477880097070,0,5,0,5,0
1991716644473195_2135582816753243,1,0,0,1,0.4215
1991716644473195_2135797986731726,1,7,0,8,0.296
1991716644473195_2135842840060574,2,0,0,2,0.9331
1991716644473195_2135872436724281,2,1,0,3,0.68
1991716644473195_2136098220035036,1,1,0,2,0.4404
1991716644473195_2136895419955316,0,4,0,4,0
1991716644473195_2137574063220785,0,2,0,2,0
1991716644473195_2138175186494006,0,2,0,2,0
1991716644473195_2138611386450386,0,3,0,3,0
1991716644473195_2138642113113980,0,9,1,10,-0.296
1991716644473195_2138845816426943,0,2,0,2,0
1991716644473195_2138971389747719,0,3,0,3,0
1991716644473195_2138974756414049,0,7,1,8,-0.4019
1991716644473195_2139033043074887,1,4,0,5,0.3612
1991716644473195_2139481969696661,1,3,1,5,0.1651
1991716644473195_2139562449688613,1,1,0,2,0.4404
1991716644473195_2139562626355262,1,2,0,3,0.6249
1991716644473195_2139609213017270,0,1,1,2,-0.5423
1991716644473195_2139636423014549,0,6,1,7,-0.296
1991716644473195_2139675543010637,0,1,0,1,0
1991716644473195_2139703323007859,3,0,0,3,1.7255
1991716644473195_2139708706340654,0,2,0,2,0
1991716644473195_2139718176339707,0,1,0,1,0
1991716644473195_2139739856337539,0,1,0,1,0
1991716644473195_2139751356336389,0,1,0,1,0
1991716644473195_2139997119645146,16,1,0,17,8.4734
1991716644473195_2139997492978442,2,1,0,3,1.1188
1991716644473195_2139997496311775,1,0,0,1,0.5719
1991716644473195_2139997499645108,1,0,0,1,0.5719
1991716644473195_2139997502978441,1,0,0,1,0.4404
1991716644473195_2139997509645107,1,0,0,1,0.4404
1991716644473195_2139997512978440,2,1,0,3,1.0464
1991716644473195_2140049006306624,1,0,0,1,0.4404
1991716644473195_2140095296301995,0,0,2,2,-0.6979
1991716644473195_2140113356300189,1,1,0,2,0.34
1991716644473195_2140159546295570,1,0,0,1,0.4215
1991716644473195_2140167639628094,1,0,0,1,0.4215
1991716644473195_2140177839627074,0,6,1,7,-0.0772
1991716644473195_2140202406291284,3,0,0,3,1.2834
1991716644473195_2140459962932195,2,0,0,2,1.1988
1991716644473195_2140648459580012,0,2,0,2,0
1991716644473195_2140690779575780,0,1,0,1,0
1991716644473195_2140691782909013,0,5,0,5,0
1991716644473195_2140692462908945,2,1,1,4,0.5848
1991716644473195_2140703222907869,1,0,0,1,0.4019
1991716644473195_2140755049569353,0,1,0,1,0
1991716644473195_2140775309567327,1,3,1,5,0
1991716644473195_2140775362900655,0,2,0,2,0
1991716644473195_2140781369566721,0,2,1,3,-0.4019
1991716644473195_2140818839562974,1,2,0,3,0.3612
1991716644473195_2140891282889063,0,2,0,2,0
1991716644473195_2141057619539096,1,2,0,3,0.4404
1991716644473195_2141392532838938,0,3,0,3,0
1991716644473195_2141393739505484,0,2,1,3,-0.296
1991716644473195_2141406792837512,1,0,0,1,0.5994
1991716644473195_2141412299503628,0,1,0,1,0
1991716644473195_2141413549503503,1,1,0,2,0.6249
1991716644473195_2141426689502189,0,2,0,2,0
1991716644473195_2141434789501379,1,0,0,1,0.765
1991716644473195_2141452502832941,1,2,1,4,-0.3326
1991716644473195_2141456766165848,1,1,0,2,0.0772
1991716644473195_2141463209498537,1,4,0,5,0.7941
1991716644473195_2141475739497284,0,1,0,1,0
1991716644473195_2141543906157134,0,1,0,1,0
1991716644473195_2141575912820600,2,2,0,4,0.7224
1991716644473195_2141711822807009,1,0,0,1,0.5994
1991716644473195_2141898206121704,4,0,0,4,2.2522
1991716644473195_2141919139452944,0,1,0,1,0
1991716644473195_2141967362781455,0,4,0,4,0
1991716644473195_2141972939447564,1,0,0,1,0.3412
1991716644473195_2141976096113915,2,3,0,5,0.9248
1991716644473195_2141977646113760,0,0,1,1,-0.4871
1991716644473195_2141989066112618,0,4,0,4,0
1991716644473195_2142069109437947,1,2,1,4,0.2146
1991716644473195_2142154176096107,5,1,0,6,2.6299
1991716644473195_2142159762762215,1,1,0,2,0.6249
1991716644473195_2142243786087146,0,1,0,1,0
1991716644473195_2142301532748038,0,9,16,25,-4.736
1991716644473195_2142341916077333,5,1,0,6,2.2651
1991716644473195_2142356049409253,1,0,0,1,0.4215
1991716644473195_2142360632742128,0,3,0,3,0
1991716644473195_2142375882740603,0,1,0,1,0
1991716644473195_2142395236072001,2,1,0,3,0.636
1991716644473195_2142654299379428,0,1,0,1,0
1991716644473195_2142694832708708,1,2,0,3,0.296
1991716644473195_2142714972706694,0,1,1,2,-0.296
1991716644473195_2142726419372216,3,2,0,5,1.8303
1991716644473195_2143028399342018,0,1,1,2,-0.296
1991716644473195_2143036642674527,0,5,0,5,0
1991716644473195_2143291572649034,1,8,5,14,-1.3416
1991716644473195_2143294505982074,2,3,0,5,0.7978
1991716644473195_2143305122647679,0,1,0,1,0
1991716644473195_2143322929312565,0,2,1,3,-0.4019
1991716644473195_2143335682644623,0,10,0,10,0
1991716644473195_2143340345977490,2,2,2,6,0.2676
1991716644473195_2143355655975959,0,1,0,1,0
1991716644473195_2143364975975027,1,3,0,4,0.8402
1991716644473195_2143419822636209,0,2,0,2,0
1991716644473195_2143454429299415,0,10,0,10,0
1991716644473195_2143454579299400,0,2,0,2,0
1991716644473195_2143461645965360,0,3,0,3,0
1991716644473195_2143475342630657,0,0,1,1,-0.296
1991716644473195_2143494232628768,0,1,1,2,-0.296
1991716644473195_2143604212617770,0,2,0,2,0
1991716644473195_2143611982616993,0,1,0,1,0
1991716644473195_2143624962615695,2,0,1,3,0.5767
1991716644473195_2143652405946284,2,1,0,3,0.6364
1991716644473195_2143865942591597,3,3,1,7,0.4624
1991716644473195_2143917415919783,2,0,1,3,1.0684
1991716644473195_2143943825917142,3,4,2,9,0.4313
1991716644473195_2143969982581193,0,1,0,1,0
1991716644473195_2143985245913000,0,5,0,5,0
1991716644473195_2144001109244747,1,0,1,2,-0.4002
1991716644473195_2144010019243856,3,2,0,5,1.6383
1991716644473195_2144010875910437,0,1,0,1,0
1991716644473195_2144011582577033,3,2,0,5,2.0827
1991716644473195_2144144415897083,0,2,1,3,-0.1779
1991716644473195_2144188102559381,0,0,1,1,-0.296
1991716644473195_2144210729223785,1,1,0,2,0.296
1991716644473195_2144224245889100,0,2,0,2,0
1991716644473195_2144261445885380,1,2,0,3,0.4404
1991716644473195_2144276545883870,0,8,0,8,0
1991716644473195_2144458795865645,1,4,3,8,-0.5898
1991716644473195_2144530905858434,0,1,0,1,0
1991716644473195_2144542222523969,0,2,1,3,-0.1779
1991716644473195_2144554239189434,4,4,0,8,1.6572
1991716644473195_2144582302519961,0,1,1,2,-0.296
1991716644473195_2144668489178009,2,0,0,2,0.8619
1991716644473195_2144668789177979,1,0,0,1,0.4215
1991716644473195_2144754912502700,2,0,0,2,1.3644
1991716644473195_2144829589161899,0,2,0,2,0
1991716644473195_2145082195803305,1,2,0,3,0.3182
1991716644473195_2145122729132585,9,7,1,17,2.7489
1991716644473195_2145135985797926,1,2,1,4,-0.3247
1991716644473195_2145153655796159,0,0,1,1,-0.296
1991716644473195_2145154742462717,0,1,0,1,0
1991716644473195_2145172839127574,0,3,0,3,0
1991716644473195_2145260352452156,1,14,1,16,0
1991716644473195_2145415402436651,1,0,1,2,0
1991716644473195_2145417262436465,1,0,0,1,0.4754
1991716644473195_2145419732436218,2,0,0,2,0.843
1991716644473195_2145437912434400,0,2,1,3,-0.4019
1991716644473195_2145441705767354,1,2,0,3,0.0772
1991716644473195_2145485535762971,4,0,0,4,2.0607
1991716644473195_2145507179094140,0,1,0,1,0
1991716644473195_2145514502426741,0,4,0,4,0
1991716644473195_2145748952403296,0,4,1,5,-0.4019
1991716644473195_2145910865720438,1,2,0,3,0.8126
1991716644473195_2145952619049596,1,1,1,3,0.044
1991716644473195_2145993492378842,0,3,0,3,0
1991716644473195_2146034899041368,0,1,0,1,0
1991716644473195_2146304545681070,0,1,1,2,-0.296
1991716644473195_2146324402345751,0,1,0,1,0
1991716644473195_2146379815673543,1,3,0,4,0.296
1991716644473195_2146389379005920,0,1,0,1,0
1991716644473195_2146394765672048,0,1,1,2,-0.296
1991716644473195_2146398652338326,0,0,1,1,-0.296
1991716644473195_2146403475671177,0,1,1,2,-0.296
1991716644473195_2146404105671114,1,0,0,1,0.34
1991716644473195_2146471472331044,0,2,1,3,-0.296
1991716644473195_2146504925661032,1,2,0,3,0.2023
1991716644473195_2146523028992555,0,2,0,2,0
1991716644473195_2146526948992163,1,6,0,7,0.4019
1991716644473195_2146527332325458,2,1,0,3,0.6572
1991716644473195_2146541245657400,1,2,1,4,0.2307
1991716644473195_2146668038978054,0,2,0,2,0
1991716644473195_2146700988974759,2,1,1,4,0.6974
1991716644473195_2146951502283041,0,2,0,2,0
1991716644473195_2146978502280341,0,1,0,1,0
1991716644473195_2147003922277799,0,3,0,3,0
1991716644473195_2147021992275992,0,1,0,1,0
1991716644473195_2147074545604070,2,2,0,4,0.6372
1991716644473195_2147088912269300,0,1,0,1,0
1991716644473195_2147155495595975,1,0,1,2,0.2146
1991716644473195_2147172515594273,0,3,0,3,0
1991716644473195_2147331645578360,0,1,0,1,0
1991716644473195_2147357332242458,0,1,0,1,0
1991716644473195_2147546012223590,0,1,0,1,0
1991716644473195_2147627898882068,1,3,1,5,0.044
1991716644473195_2147666188878239,0,2,1,3,-0.4019
1991716644473195_2147684998876358,0,2,0,2,0
1991716644473195_2147705302207661,1,2,0,3,0.3612
1991716644473195_2147708022207389,2,1,0,3,0.592
1991716644473195_2147715528873305,0,1,0,1,0
1991716644473195_2147723298872528,0,1,0,1,0
1991716644473195_2147738785537646,1,3,1,5,-0.0607
1991716644473195_2147753182202873,0,2,0,2,0
1991716644473195_2147764812201710,0,3,0,3,0
1991716644473195_2147781332200058,1,2,0,3,0.5106
1991716644473195_2147781542200037,0,4,0,4,0
1991716644473195_2147878505523674,0,1,0,1,0
1991716644473195_2147964128848445,1,1,0,2,0.765
1991716644473195_2148241658820692,2,1,0,3,1.2917
1991716644473195_2148260165485508,0,1,0,1,0
1991716644473195_2148329325478592,0,6,1,7,-0.1531
1991716644473195_2148338232144368,0,1,1,2,-0.4019
1991716644473195_2148342142143977,0,0,1,1,-0.1027
1991716644473195_2148375992140592,3,4,0,7,1.1216
1991716644473195_2148426058802252,0,2,0,2,0
1991716644473195_2148450368799821,1,3,0,4,0.4404
1991716644473195_2148479548796903,0,2,1,3,-0.296
1991716644473195_2148535658791292,1,4,1,6,0.044
1991716644473195_2148576135453911,0,1,0,1,0
1991716644473195_2148577935453731,3,0,0,3,1.2834
1991716644473195_2148829768761881,0,2,0,2,0
1991716644473195_2148836308761227,1,3,0,4,0.8442
1991716644473195_2148839442094247,1,0,0,1,0.3182
1991716644473195_2148858465425678,0,0,1,1,-0.296
1991716644473195_2148872775424247,1,4,0,5,0.212
1991716644473195_2148909882087203,0,2,1,3,-0.296
1991716644473195_2148928522085339,0,2,0,2,0
1991716644473195_2148954672082724,0,2,0,2,0
1991716644473195_2148955028749355,4,7,1,12,1.7464
1991716644473195_2148990925412432,1,1,0,2,0.296
1991716644473195_2149002228744635,0,3,1,4,-0.296
1991716644473195_2149051012073090,4,0,0,4,2.6801
1991716644473195_2149122492065942,0,2,2,4,-0.592
1991716644473195_2149147522063439,0,2,0,2,0
1991716644473195_2149172448727613,0,3,0,3,0
1991716644473195_2149277132050478,3,0,0,3,1.6392
1991716644473195_2149579545353570,0,5,0,5,0
1991716644473195_2149610735350451,1,0,0,1,0.5994
1991716644473195_2149627805348744,0,1,0,1,0
1991716644473195_2149651135346411,1,0,0,1,0.765
1991716644473195_2149652208679637,0,1,0,1,0
1991716644473195_2149652218679636,0,3,0,3,0
1991716644473195_2149652235346301,2,1,0,3,0.7804
1991716644473195_2149655618679296,1,2,0,3,0.6249
1991716644473195_2149678635343661,0,1,0,1,0
1991716644473195_2149702692007922,0,1,0,1,0
1991716644473195_2149751215336403,0,3,0,3,0
1991716644473195_2149753762002815,0,3,0,3,0
1991716644473195_2149793268665531,0,6,0,6,0
1991716644473195_2149806085330916,1,4,0,5,0.4404
1991716644473195_2149806321997559,0,1,0,1,0
1991716644473195_2149807928664065,1,6,0,7,0.34
1991716644473195_2149809361997255,0,1,0,1,0
1991716644473195_2149809801997211,1,0,0,1,0.765
1991716644473195_2149840308660827,2,1,0,3,0.3554
1991716644473195_2149852251992966,0,1,0,1,0
1991716644473195_2150063238638534,0,1,0,1,0
1991716644473195_2150067868638071,2,9,1,12,0.7252
1991716644473195_2150092151968976,2,13,5,20,-0.612
1991716644473195_2150108318634026,3,1,0,4,1.9519
1991716644473195_2150109631967228,2,1,0,3,1.0209
1991716644473195_2150109885300536,0,5,0,5,0
1991716644473195_2150111545300370,1,0,0,1,0.765
1991716644473195_2150111795300345,1,0,0,1,0.765
1991716644473195_2150129988631859,0,4,0,4,0
1991716644473195_2150157791962412,1,3,0,4,0.5267
1991716644473195_2150163841961807,0,1,0,1,0
1991716644473195_2150164825295042,0,1,0,1,0
1991716644473195_2150220098622848,3,0,0,3,1.4527
1991716644473195_2150221045289420,1,3,0,4,0.7003
1991716644473195_2150230695288455,0,1,1,2,-0.0772
1991716644473195_2150231185288406,0,1,1,2,-0.296
1991716644473195_2150257825285742,0,5,0,5,0
1991716644473195_2150276395283885,0,0,1,1,-0.296
1991716644473195_2150276841950507,1,2,0,3,0.34
1991716644473195_2150301028614755,0,2,1,3,-0.296
1991716644473195_2150302065281318,0,5,0,5,0
1991716644473195_2150328431945348,2,3,0,5,0.5176
1991716644473195_2150328865278638,0,4,1,5,-0.296
1991716644473195_2150346411943550,1,0,0,1,0.4404
1991716644473195_2150363998608458,2,3,0,5,0.6183
1991716644473195_2150390581939133,5,0,0,5,2.6077
1991716644473195_2150406551937536,0,2,0,2,0
1991716644473195_2150725308572327,23,2,0,25,11.9115
1991716644473195_2150730291905162,0,1,0,1,0
1991716644473195_2150733028571555,0,1,0,1,0
1991716644473195_2150744855237039,0,2,0,2,0
1991716644473195_2150753665236158,1,0,0,1,0.4215
1991716644473195_2150758251902366,0,2,0,2,0
1991716644473195_2150776918567166,1,0,0,1,0.4404
1991716644473195_2150821448562713,2,0,0,2,1.1003
1991716644473195_2150822811895910,7,4,0,11,3.9618
1991716644473195_2150836451894546,1,1,0,2,0.4404
1991716644473195_2150837788561079,1,1,0,2,0.6697
1991716644473195_2150851251893066,0,5,0,5,0
1991716644473195_2150854238559434,0,1,1,2,-0.296
1991716644473195_2150883291889862,1,2,0,3,0.5106
1991716644473195_2150891068555751,0,1,0,1,0
1991716644473195_2150906521887539,0,1,0,1,0
1991716644473195_2150955095216015,1,4,0,5,0.5106
1991716644473195_2151029625208562,0,0,1,1,-0.296
1991716644473195_2151040418540816,5,2,1,8,2.8471
1991716644473195_2151090498535808,0,3,0,3,0
1991716644473195_2151124051865786,0,2,0,2,0
1991716644473195_2151137165197808,1,1,0,2,0.34
1991716644473195_2151337228511135,4,1,0,5,1.8312
1991716644473195_2151397558505102,0,1,0,1,0
1991716644473195_2151402945171230,0,1,0,1,0
1991716644473195_2151544515157073,0,1,0,1,0
1991716644473195_2151552725156252,0,3,0,3,0
1991716644473195_2151586695152855,0,2,0,2,0
1991716644473195_2151594271818764,8,0,0,8,3.4961
1991716644473195_2151604958484362,0,1,0,1,0
1991716644473195_2151695185142006,0,2,0,2,0
1991716644473195_2151795291798662,1,4,1,6,0.3647
1991716644473195_2151984931779698,0,2,1,3,-0.296
1991716644473195_2152022181775973,0,1,0,1,0
1991716644473195_2152039458440912,0,1,0,1,0
1991716644473195_2152046005106924,0,1,0,1,0
1991716644473195_2152048181773373,2,0,0,2,0.8619
1991716644473195_2152049361773255,0,2,0,2,0
1991716644473195_2152068041771387,2,0,0,2,0.8808
1991716644473195_2152069381771253,0,2,0,2,0
1991716644473195_2152082191769972,1,2,0,3,0.4404
1991716644473195_2152085315102993,0,1,0,1,0
1991716644473195_2152088515102673,0,1,0,1,0
1991716644473195_2152120995099425,1,0,0,1,0.4404
1991716644473195_2152123215099203,0,2,0,2,0
1991716644473195_2152243508420507,0,1,0,1,0
1991716644473195_2152261981751993,3,0,0,3,1.0546
1991716644473195_2152324898412368,0,4,0,4,0
1991716644473195_2152368025074722,2,1,1,4,1.1239
1991716644473195_2152391915072333,1,3,0,4,0.5719
1991716644473195_2152576571720534,0,1,0,1,0
1991716644473195_2152605125051012,1,1,0,2,0.0772
1991716644473195_2152618581716333,0,2,0,2,0
1991716644473195_2152678071710384,5,2,0,7,2.753
1991716644473195_2152705328374325,0,4,1,5,-0.4019
1991716644473195_2152721825039342,1,7,0,8,0.296
1991716644473195_2152765395034985,1,1,1,3,-0.0603
1991716644473195_2152769188367939,0,2,0,2,0
1991716644473195_2152769388367919,1,1,1,3,0
1991716644473195_2152775901700601,7,0,0,7,3.4932
1991716644473195_2152779241700267,0,2,0,2,0
1991716644473195_2152790958365762,0,2,0,2,0
1991716644473195_2152873685024156,1,2,0,3,0.34
1991716644473195_2152875951690596,0,1,0,1,0
1991716644473195_2152928805018644,1,2,0,3,0.5859
1991716644473195_2152930851685106,4,0,0,4,1.5306
1991716644473195_2152931691685022,1,2,0,3,0.5106
1991716644473195_2152989965012528,1,0,0,1,0.765
1991716644473195_2153144794997045,0,1,0,1,0
1991716644473195_2153184144993110,3,0,0,3,1.3023
1991716644473195_2153217184989806,0,2,1,3,-0.296
1991716644473195_2153249714986553,2,1,0,3,0.8808
1991716644473195_2153280498316808,0,0,1,1,-0.4019
1991716644473195_2153324724979052,0,1,0,1,0
1991716644473195_2153406994970825,18,4,0,22,9.1105
1991716644473195_2153407708304087,3,20,2,25,0.4722
1991716644473195_2153472664964258,8,1,0,9,3.688
1991716644473195_2153517178293140,2,5,0,7,0.459
1991716644473195_2153529274958597,0,1,0,1,0
1991716644473195_2153535644957960,2,4,0,6,0.6142
1991716644473195_2153830288261829,4,0,0,4,2.3384
1991716644473195_2153963744915150,2,3,0,5,1.1713
1991716644473195_2154041361574055,1,2,0,3,0.296
1991716644473195_2154047638240094,0,3,1,4,-0.296
1991716644473195_2154216254889899,4,2,0,6,1.962
1991716644473195_2154555331522658,1,3,0,4,0.3612
1991716644473195_2154589754852549,0,1,0,1,0
1991716644473195_2154667508178107,0,1,1,2,-0.296
1991716644473195_2154921731486018,0,1,0,1,0
1991716644473195_2154930014818523,1,3,2,6,-0.3579
1991716644473195_2155334428111415,0,5,1,6,-0.5423
1991716644473195_2155380458106812,0,0,1,1,-0.296
1991716644473195_2155538044757720,0,1,0,1,0
1991716644473195_2155650284746496,4,2,0,6,2.1271
1991716644473195_2155960758048782,3,0,0,3,1.597
1991716644473195_2156018648042993,0,5,0,5,0
1991716644473195_2156053744706150,0,2,0,2,0
1991716644473195_2156106101367581,0,1,1,2,-0.296
1991716644473195_2156228191355372,0,2,0,2,0
1991716644473195_2156239041354287,0,3,1,4,-0.0772
1991716644473195_2156523047992553,11,3,0,14,5.6786
1991716644473195_2156747597970098,0,3,0,3,0
1991716644473195_2156816217963236,0,2,1,3,-0.296
1991716644473195_2156822347962623,1,0,0,1,0.5994
1991716644473195_2156824564629068,0,4,0,4,0
1991716644473195_2156858501292341,1,1,0,2,0.3182
1991716644473195_2157233564588168,0,3,1,4,-0.296
1991716644473195_2157375231240668,0,1,0,1,0
1991716644473195_2157405024571022,0,1,0,1,0
1991716644473195_2157408011237390,0,2,0,2,0
1991716644473195_2157428657901992,1,1,0,2,0.34
1991716644473195_2157617897883068,16,1,0,17,8.8093
1991716644473195_2157650367879821,1,1,0,2,0.34
1991716644473195_2157696427875215,1,0,0,1,0.4215
1991716644473195_2157706287874229,0,1,1,2,-0.296
1991716644473195_2158054324506092,2,2,0,4,0.636
1991716644473195_2158146927830165,2,0,0,2,0.8808
1991716644473195_2158334514478073,3,11,1,15,0.9992
1991716644473195_2158355421142649,1,2,0,3,0.34
1991716644473195_2158676794443845,16,9,0,25,10.9098
1991716644473195_2158791627765695,0,2,0,2,0
1991716644473195_2158809404430584,1,1,0,2,0.4404
1991716644473195_2158826511095540,0,2,0,2,0
1991716644473195_2158949054416619,3,0,0,3,1.4868
1991716644473195_2159279371050254,1,0,0,1,0.4215
1991716644473195_2159297394381785,1,1,0,2,0.0772
1991716644473195_2159322441045947,2,0,0,2,0.8969
1991716644473195_2160418727602985,8,1,0,9,3.6655
1991716644473195_2160421134269411,6,0,0,6,2.8241
1991716644473195_2160486494262875,1,2,0,3,0.296
1991716644473195_2160766904234834,2,2,0,4,0.8066
1991716644473195_2161085927536265,1,2,0,3,0.4927
1991716644473195_2161682144143310,0,4,0,4,0
1991716644473195_2162531440725047,2,0,0,2,0.9626
1991716644473195_2162981047346753,4,0,0,4,1.8361
1991716644473195_2164828773828647,21,4,0,25,11.9989
1991716644473195_2168479350130256,5,1,1,7,3.322
1991716644473195_2172161076428750,2,1,0,3,1.1701
1991716644473195_2175082002803324,11,1,0,12,5.8454
1991716644473195_2175355059442685,12,2,0,14,7.1141
1991716644473195_2175392102772314,4,2,0,6,2.3249
1991716644473195_2175406729437518,7,4,0,11,3.9042
1991716644473195_2175552272756297,11,7,1,19,5.9335
1991716644473195_2176163112695213,2,0,0,2,0.7198
1991716644473195_2176753979302793,6,1,0,7,3.3897
1991716644473195_2177487679229423,2,1,0,3,0.9499
1991716644473195_2179245782386946,0,1,0,1,0
1991716644473195_2179946232316901,10,8,0,18,5.0908
1991716644473195_2180139268964264,21,3,1,25,11.0201
1991716644473195_2182059715438886,5,0,0,5,2.8518
1991716644473195_2182677888710402,14,1,0,15,7.0922
1991716644473195_2182701152041409,8,0,0,8,3.1541
1991716644473195_2183843585260499,1,0,0,1,0.296
1991716644473195_2183846301926894,0,1,0,1,0
1991716644473195_2184506241860900,10,1,0,11,4.5647
1991716644473195_2185023031809221,1,0,0,1,0.4215
1991716644473195_2185057468472444,0,1,0,1,0
1991716644473195_2185809841730540,2,0,0,2,0.8619
1991716644473195_2186220431689481,3,0,0,3,1.5622
1991716644473195_2186920858286105,1,0,0,1,0.7297
1991716644473195_2187849941526530,1,0,0,1,0.4404
1991716644473195_2188238564821001,0,1,0,1,0
1991716644473195_2188929834751874,0,0,1,1,-0.296
1991716644473195_2189505001361024,8,1,0,9,3.9892
1991716644473195_2189779651333559,9,2,0,11,5.033
1991716644473195_2190141831297341,1,0,0,1,0.8957
1991716644473195_2190154257962765,5,4,0,9,2.4441
1991716644473195_2190240694620788,1,1,0,2,0.3182
1991716644473195_2191125231199001,22,2,0,24,10.2626
1991716644473195_2191808821130642,1,0,0,1,0.7717
1991716644473195_2191876157790575,4,0,0,4,2.0928
1991716644473195_2191901031121421,1,0,0,1,0.4215
1991716644473195_2192173297760861,3,2,0,5,1.6105
1991716644473195_2192259971085527,6,1,0,7,3.5283
1991716644473195_2192981797680011,1,1,0,2,0.4215
1991716644473195_2192982804346577,9,0,0,9,4.3965
1991716644473195_2193139517664239,3,1,0,4,1.3023
1991716644473195_2193237420987782,1,0,0,1,0.4215
1991716644473195_2193335607644630,2,0,0,2,0.8619
1991716644473195_2193513700960154,2,0,0,2,0.9142
1991716644473195_2193693200942204,2,0,0,2,0.8969
1991716644473195_2193718774272980,2,0,0,2,0.4987
1991716644473195_2193755310935993,2,2,0,4,1.2599
1991716644473195_2193787170932807,3,1,0,4,1.7039
1991716644473195_2193828637595327,6,0,0,6,2.7793
1991716644473195_2194456610865863,7,2,0,9,3.1691
1991716644473195_2194558927522298,4,2,0,6,1.7616
1991716644473195_2194607360850788,3,0,0,3,1.3023
1991716644473195_2195062180805306,4,0,0,4,2.2098
1991716644473195_2195064594138398,3,0,0,3,1.3723
1991716644473195_2195160794128778,2,1,0,3,0.8808
1991716644473195_2195293344115523,2,0,0,2,1.338
1991716644473195_2195807380730786,4,0,0,4,2.0862
1991716644473195_2195897724055085,16,0,0,16,7.0991
1991716644473195_2195917470719777,1,0,0,1,0.4404
1991716644473195_2196458740665650,1,0,0,1,0.4404
1991716644473195_2196780280633496,0,1,0,1,0
1991716644473195_2197057157272475,1,1,0,2,0.4927
1991716644473195_2197073400604184,0,0,1,1,-0.296
1991716644473195_2197802293864628,7,11,2,20,2.6817
1991716644473195_2197889880522536,4,11,0,15,2.2014
1991716644473195_2197913197186871,2,4,0,6,1.1988
1991716644473195_2197916533853204,3,10,1,14,0.821
1991716644473195_2198192133825644,1,17,0,18,0.5994
1991716644473195_2198252547152936,0,1,0,1,0
1991716644473195_2198273323817525,0,9,1,10,-0.4019
1991716644473195_2198528407125350,5,13,0,18,2.0982
1991716644473195_2198569753787882,0,5,0,5,0
1991716644473195_2198578690453655,2,13,1,16,0.4626
1991716644473195_2198592397118951,0,1,4,5,-1.4201
1991716644473195_2198593447118846,1,0,0,1,0.4404
1991716644473195_2198859190425605,1,0,0,1,0.0772
1991716644473195_2198905623754295,0,2,0,2,0
1991716644473195_2199067533738104,2,5,1,8,0.296
1991716644473195_2199068457071345,2,0,0,2,0.9084
1991716644473195_2199137757064415,2,0,0,2,0.7999
1991716644473195_2199194213725436,0,3,0,3,0
1991716644473195_2199238603720997,1,0,0,1,0.5994
1991716644473195_2199334087044782,1,3,0,4,0.4939
1991716644473195_2199466007031590,1,0,0,1,0.5994
1991716644473195_2199483160363208,0,4,0,4,0
1991716644473195_2199507043694153,1,0,0,1,0.5994
1991716644473195_2199581063686751,0,13,0,13,0
1991716644473195_2199663590345165,1,1,0,2,0.4404
1991716644473195_2199668817011309,0,4,0,4,0
1991716644473195_2199669167011274,1,3,0,4,0.5994
1991716644473195_2199677417010449,1,4,0,5,0.5267
1991716644473195_2199681367010054,0,6,0,6,0
1991716644473195_2199682350343289,3,0,0,3,1.7255
1991716644473195_2199706557007535,2,2,1,5,0.5994
1991716644473195_2199748617003329,8,0,0,8,3.8379
1991716644473195_2199782313666626,1,1,2,4,-0.2615
1991716644473195_2199810706997120,2,0,1,3,0.6721
1991716644473195_2200005340310990,1,6,0,7,0.5434
1991716644473195_2200262633618594,3,0,0,3,1.3212
1991716644473195_2200288420282682,1,0,0,1,0.5267
1991716644473195_2200522110259313,1,0,0,1,0.4404
1991716644473195_2200620736916117,1,0,0,1,0.4404
1991716644473195_2200703366907854,4,3,0,7,2.3964
1991716644473195_2200717190239805,1,0,0,1,0.0772
1991716644473195_2200988036879387,0,2,0,2,0
1991716644473195_2201054883539369,0,18,3,21,-0.9065
1991716644473195_2201267590184765,5,0,0,5,2.202
1991716644473195_2201688293476028,4,3,0,7,2.0215
1991716644473195_2201792993465558,3,4,0,7,1.7982
1991716644473195_2201833126794878,3,2,0,5,1.7255
1991716644473195_2201853160126208,1,0,0,1,0.4215
1991716644473195_2202421200069404,0,2,0,2,0
1991716644473195_2202546243390233,9,0,0,9,4.2941
1991716644473195_2202647003380157,0,1,0,1,0
1991716644473195_2202695793375278,1,3,0,4,0.5994
1991716644473195_2202741633370694,1,0,0,1,0.4215
1991716644473195_2203222943322563,1,1,0,2,0.3182
1991716644473195_2203302289981295,1,1,0,2,0.4404
1991716644473195_2203841556594035,4,3,0,7,1.8674
1991716644473195_2203877423257115,0,1,0,1,0
1991716644473195_2204054203239437,5,1,0,6,2.5077
1991716644473195_2204342656543925,1,0,0,1,0.6597
1991716644473195_2204471913197666,1,0,0,1,0.4404
1991716644473195_2204665583178299,1,0,0,1,0.5267
1991716644473195_2204756426502548,3,1,0,4,1.2659
1991716644473195_2205049629806561,2,2,0,4,1.1988
1991716644473195_2205062759805248,3,6,0,9,1.0831
1991716644473195_2205125439798980,1,1,0,2,0.4404
1991716644473195_2205140216464169,0,1,0,1,0
1991716644473195_2205324449779079,0,1,0,1,0
1991716644473195_2205329989778525,0,1,0,1,0
1991716644473195_2205346333110224,1,5,0,6,0.3412
1991716644473195_2205639936414197,0,1,1,2,-0.3182
1991716644473195_2205714393073418,0,24,1,25,-0.7906
1991716644473195_2205827679728756,0,1,0,1,0
1991716644473195_2205829109728613,1,6,2,9,-0.5764
1991716644473195_2206409373003920,1,0,0,1,0.5267
1991716644473195_2206413783003479,3,20,0,23,0.665
1991716644473195_2206419099669614,0,1,0,1,0
1991716644473195_2206472092997648,0,1,0,1,0
1991716644473195_2206530329658491,1,0,0,1,0.4404
1991716644473195_2206535702991287,1,0,0,1,0.7783
1991716644473195_2206549456323245,0,0,1,1,-0.296
1991716644473195_2206585302986327,0,6,0,6,0
1991716644473195_2206713966306794,1,0,0,1,0.5267
1991716644473195_2206727156305475,0,3,1,4,-0.5106
1991716644473195_2206735359637988,1,0,0,1,0.5994
1991716644473195_2206759516302239,0,1,0,1,0
1991716644473195_2206772826300908,1,10,1,12,0.0559
1991716644473195_2206807092964148,1,0,0,1,0.5994
1991716644473195_2207078906270300,4,20,1,25,0.7568
1991716644473195_2207119739599550,0,2,0,2,0
1991716644473195_2207130249598499,2,2,0,4,1.1261
1991716644473195_2207138269597697,0,2,1,3,-0.5267
1991716644473195_2207168846261306,0,1,0,1,0
1991716644473195_2207281969583327,0,2,0,2,0
1991716644473195_2207409819570542,0,1,0,1,0
1991716644473195_2207640072880850,1,0,0,1,0.5994
1991716644473195_2207641682880689,1,0,0,1,0.4215
1991716644473195_2207730689538455,0,1,0,1,0
1991716644473195_2207849652859892,1,1,0,2,0.3818
1991716644473195_2207928662851991,1,0,0,1,0.5994
1991716644473195_2207932276184963,1,0,0,1,0.4754
1991716644473195_2208049692839888,12,12,1,25,5.923
1991716644473195_2208401536138037,4,1,0,5,1.7049
1991716644473195_2208407646137426,1,0,0,1,0.4404
1991716644473195_2208964219415102,1,0,0,1,0.4754
1991716644473195_2208988289412695,2,0,0,2,0.8969
1991716644473195_2209093439402180,2,0,0,2,1.2819
1991716644473195_2209166196061571,23,1,0,24,12.7976
1991716644473195_2209253742719483,4,0,0,4,1.7966
1991716644473195_2209287166049474,1,0,0,1,0.4404
1991716644473195_2209288702715987,0,1,0,1,0
1991716644473195_2209311506047040,2,0,0,2,0.9331
1991716644473195_2209358316042359,2,0,0,2,1.4262
1991716644473195_2209455546032636,2,0,0,2,0.8808
1991716644473195_2209534092691448,0,1,0,1,0
1991716644473195_2209561732688684,2,0,0,2,1.0464
1991716644473195_2209651756013015,3,0,0,3,1.4262
1991716644473195_2209662796011911,0,1,0,1,0
1991716644473195_2209783159333208,1,2,1,4,0.1255
1991716644473195_2209835435994647,1,0,0,1,0.4215
1991716644473195_2209898489321675,2,1,0,3,1.1001
1991716644473195_2209908355987355,1,3,0,4,0.6249
1991716644473195_2209917485986442,1,0,0,1,0.4754
1991716644473195_2209932809318243,1,0,0,1,0.4754
1991716644473195_2209950515983139,3,1,0,4,1.2645
1991716644473195_2210265482618309,0,1,0,1,0
1991716644473195_2210266062618251,0,1,0,1,0
1991716644473195_2210387082606149,1,0,0,1,0.6249
1991716644473195_2210438839267640,7,0,0,7,3.6104
1991716644473195_2210441365934054,2,0,0,2,1.711
1991716644473195_2210559465922244,1,0,0,1,0.4754
1991716644473195_2210948869216637,2,0,0,2,0.9681
1991716644473195_2211179015860289,1,0,0,1,0.4754
1991716644473195_2211211469190377,3,0,0,3,1.0882
1991716644473195_2211212272523630,1,0,0,1,0.5994
1991716644473195_2211237129187811,0,3,0,3,0
1991716644473195_2211248339186690,1,0,0,1,0.4939
1991716644473195_2211628549148669,0,2,0,2,0
1991716644473195_2211943529117171,3,1,0,4,1.4424
1991716644473195_2212276269083897,3,0,0,3,1.3912
1991716644473195_2212406769070847,0,1,0,1,0
1991716644473195_2213084755669715,4,3,0,7,1.9272
1991716644473195_2213331435645047,2,0,0,2,1.4052
1991716644473195_2213331768978347,4,1,0,5,1.9446
1991716644473195_2213623305615860,0,1,0,1,0
1991716644473195_2213624565615734,3,0,0,3,1.2834
1991716644473195_2213638488947675,1,0,0,1,0.4754
1991716644473195_2213986512246206,2,1,0,3,0.8619
1991716644473195_2213990338912490,18,6,0,24,7.8886
1991716644473195_2214230575555133,7,4,0,11,3.7622
1991716644473195_2215253835452807,1,0,0,1,0.6597
1991716644473195_2215278578783666,2,22,1,25,0.4052
1991716644473195_2215441158767408,4,1,0,5,1.8473
1991716644473195_2215446325433558,1,0,0,1,0.4215
1991716644473195_2215975435380647,3,7,0,10,0.7136
1991716644473195_2215997382045119,0,4,0,4,0
1991716644473195_2217021348609389,1,2,0,3,0.0772
1991716644473195_2217217608589763,2,1,1,4,0.5541
1991716644473195_2217299205248270,0,1,0,1,0
1991716644473195_2217300648581459,1,1,0,2,0.4019
1991716644473195_2217305048581019,0,4,0,4,0
1991716644473195_2217656831879174,0,1,0,1,0
1991716644473195_2218133775164813,0,1,0,1,0
1991716644473195_2218492918462232,23,1,1,25,11.4371
1991716644473195_2218904238421100,1,0,0,1,0.0772
1991716644473195_2219034768408047,2,0,0,2,1.1625
1991716644473195_2219154968396027,2,0,0,2,0.9158
1991716644473195_2220316698279854,1,0,0,1,0.6249
1991716644473195_2221797231465134,4,0,0,4,2.1318
1991716644473195_2223393757972148,0,6,1,7,-0.5719
1991716644473195_2223676967943827,1,0,0,1,0.7297
1991716644473195_2224128201232037,1,0,0,1,0.4404
1991716644473195_2224731257838398,5,1,0,6,2.9174
1991716644473195_2224811487830375,0,1,2,3,-0.8679
1991716644473195_2224861094492081,1,0,0,1,0.4404
1991716644473195_2225319877779536,0,11,0,11,0
1991716644473195_2225683724409818,0,1,0,1,0
1991716644473195_2225741057737418,3,2,0,5,1.3373
1991716644473195_2225967641048093,1,11,3,15,-1.2578
1991716644473195_2226358294342361,3,0,0,3,1.4932
1991716644473195_2226660244312166,0,1,0,1,0
1991716644473195_2226726587638865,2,0,0,2,0.8808
1991716644473195_2226960384282152,9,5,0,14,5.2302
1991716644473195_2226968240948033,5,0,0,5,2.5757
1991716644473195_2227054270939430,1,1,0,2,0.3182
1991716644473195_2227114884266702,0,1,0,1,0
1991716644473195_2227118110933046,0,1,0,1,0
1991716644473195_2227267877584736,25,0,0,25,12.4075
1991716644473195_2227677524210438,11,4,0,15,4.999
1991716644473195_2227937834184407,1,0,0,1,0.4404
1991716644473195_2228181537493370,1,0,0,1,0.4215
1991716644473195_2228404180804439,0,1,0,1,0
1991716644473195_2228617580783099,7,1,1,9,3.3091
1991716644473195_2228975097414014,4,1,0,5,1.4272
1991716644473195_2229188750725982,5,3,1,9,2.711
1991716644473195_2229620900682767,23,2,0,25,12.7
1991716644473195_2230185473959643,6,0,0,6,2.7825
1991716644473195_2230448250600032,2,0,0,2,0.8808
1991716644473195_2230727223905468,1,0,0,1,0.4927
1991716644473195_2230831533895037,1,0,0,1,0.4404
1991716644473195_2230853090559548,1,2,0,3,0.4404
1991716644473195_2231047430540114,1,2,0,3,0.5994
1991716644473195_2231417190503138,5,18,2,25,-0.2194
1991716644473195_2231496933828497,3,0,0,3,2.4601
1991716644473195_2231730050471852,4,0,0,4,1.9461
1991716644473195_2232112247100299,0,1,0,1,0
1991716644473195_2232180817093442,1,0,0,1,0.7269
1991716644473195_2232318280413029,15,10,0,25,3.8998
1991716644473195_2232786420366215,0,1,0,1,0
1991716644473195_2233347670310090,4,5,0,9,1.6369
1991716644473195_2233393926972131,1,0,0,1,0.4019
1991716644473195_2233395266971997,4,3,0,7,1.7392
1991716644473195_2233993800245477,2,1,0,3,0.843
1991716644473195_2234530710191786,4,21,0,25,1.1557
1991716644473195_2234785963499594,2,0,0,2,0.9331
1991716644473195_2235501820094675,0,2,0,2,0
1991716644473195_2235540226757501,1,0,0,1,0.5106
1991716644473195_2237512829893574,16,0,0,16,8.6839
1991716644473195_2238132936498230,0,1,1,2,-0.296
1991716644473195_2239635623014628,2,1,0,3,0.8808
1991716644473195_2241403102837880,1,0,0,1,0.4215
1991716644473195_2243270442651146,3,1,0,4,1.3735
1991716644473195_2247244608920396,2,0,0,2,0.8808
1991716644473195_2248365495474974,1,10,1,12,0.1404
1991716644473195_2249442215367302,13,1,0,14,5.8876
1991716644473195_2249847295326794,7,0,0,7,3.4694
1991716644473195_2250480231930167,19,6,0,25,9.8782
1991716644473195_2253294348315422,2,1,0,3,0.8619
1991716644473195_2253294914982032,2,0,0,2,0.843
1991716644473195_2253295474981976,0,3,0,3,0
1991716644473195_2253297061648484,5,15,5,25,0.1707
1991716644473195_2253357381642452,0,1,0,1,0
1991716644473195_2253361371642053,0,3,0,3,0
1991716644473195_2253749934936530,1,0,0,1,0.4404
1991716644473195_2253802644931259,1,2,1,4,-0.1976
1991716644473195_2256587767986080,4,1,0,5,1.643
1991716644473195_2256590391319151,3,3,1,7,1.0775
1991716644473195_2256619851316205,11,2,1,14,4.9576
1991716644473195_2256623834649140,1,0,1,2,0.2382
1991716644473195_2256670981311092,1,0,0,1,0.4404
1991716644473195_2256743297970527,1,0,0,1,0.4927
1991716644473195_2257238024587721,2,0,0,2,1.0812
1991716644473195_2257253554586168,1,0,0,1,0.4927
1991716644473195_2257458671232323,2,0,0,2,1.1524
1991716644473195_2257579384553585,2,0,0,2,1.1993
1991716644473195_2257580301220160,1,0,0,1,0.659
1991716644473195_2262522027392654,1,1,0,2,0.7184
1991716644473195_2262603677384489,6,3,1,10,1.2334
1991716644473195_2262932400684950,1,0,0,1,0.7269
1991716644473195_2262933310684859,1,0,0,1,0.7269
1991716644473195_2263237283987795,1,2,0,3,0.8807
1991716644473195_2263662173945306,3,4,1,8,1.0605
1991716644473195_2263665067278350,2,4,0,6,0.592
1991716644473195_2264039733907550,0,3,0,3,0
1991716644473195_2264069257237931,3,1,0,4,0.888
1991716644473195_2264229670555223,0,3,0,3,0
1991716644473195_2264720900506100,1,0,0,1,0.7269
1991716644473195_2264721130506077,1,0,0,1,0.7269
1991716644473195_2265452040432986,0,1,1,2,-0.485
1991716644473195_2266960230282167,0,1,0,1,0
1991716644473195_2267673760210814,3,1,0,4,1.7044
1991716644473195_2268008613510662,1,2,1,4,-0.168
1991716644473195_2269250440053146,2,12,0,14,1.4309
1991716644473195_2269485663362957,1,16,0,17,0.5106
1991716644473195_2270305783280945,0,1,0,1,0
1991716644473195_2270713573240166,4,17,3,24,1.6009
1991716644473195_2271294203182103,1,2,0,3,0.34
1991716644473195_2271294806515376,1,2,2,5,-0.1901
1991716644473195_2271784956466361,2,0,0,2,0.8619
1991716644473195_2272041949773995,1,23,1,25,-0.0468
1991716644473195_2272052543106269,2,9,1,12,0.2048
1991716644473195_2272053876439469,1,4,0,5,0.2732
1991716644473195_2272061526438704,10,14,1,25,2.1245
1991716644473195_2272061549772035,1,20,4,25,-0.7852
1991716644473195_2272077259770464,1,2,0,3,0.5994
1991716644473195_2272079299770260,2,13,4,19,-0.8328
1991716644473195_2272094939768696,2,8,2,12,0.2543
1991716644473195_2272095499768640,7,16,2,25,1.8694
1991716644473195_2272101923101331,0,1,0,1,0
1991716644473195_2272103456434511,0,4,0,4,0
1991716644473195_2272105279767662,0,4,1,5,-0.1027
1991716644473195_2272106026434254,1,0,0,1,0.5994
1991716644473195_2272109019767288,2,3,0,5,0.8808
1991716644473195_2272109856433871,0,1,0,1,0
1991716644473195_2272111449767045,5,15,5,25,-0.7298
1991716644473195_2272112513100272,3,4,1,8,1.3381
1991716644473195_2272114953100028,1,5,0,6,0.4404
1991716644473195_2272118173099706,0,1,0,1,0
1991716644473195_2272120599766130,2,22,1,25,0.3077
1991716644473195_2272127946432062,3,5,0,8,0.932
1991716644473195_2272128616431995,4,12,0,16,1.3164
1991716644473195_2272133536431503,0,3,1,4,-0.4404
1991716644473195_2272133686431488,1,11,1,13,-0.0903
1991716644473195_2272134399764750,2,8,1,11,0.4886
1991716644473195_2272136189764571,1,2,0,3,0.34
1991716644473195_2272136879764502,2,2,0,4,1.0563
1991716644473195_2272142119763978,0,0,1,1,-0.7096
1991716644473195_2272142389763951,1,0,0,1,0.5267
1991716644473195_2272143403097183,1,0,0,1,0.5423
1991716644473195_2272143806430476,1,0,0,1,0.5267
1991716644473195_2272144423097081,1,10,2,13,-0.533
1991716644473195_2272144506430406,3,1,0,4,1.1906
1991716644473195_2272145659763624,1,3,0,4,0.5267
1991716644473195_2272145779763612,0,1,0,1,0
1991716644473195_2272149696429887,3,3,0,6,1.037
1991716644473195_2272150619763128,2,0,0,2,1.11
1991716644473195_2272151163096407,1,1,0,2,0.0772
1991716644473195_2272151406429716,3,2,1,6,1.118
1991716644473195_2272151479763042,1,0,0,1,0.5267
1991716644473195_2272152709762919,0,6,0,6,0
1991716644473195_2272152873096236,0,1,0,1,0
1991716644473195_2272153519762838,1,0,0,1,0.4754
1991716644473195_2272153579762832,1,0,0,1,0.4137
1991716644473195_2272155256429331,2,1,0,3,1.1625
1991716644473195_2272155366429320,0,2,0,2,0
1991716644473195_2272157323095791,1,0,0,1,0.5267
1991716644473195_2272157329762457,1,1,0,2,0.34
1991716644473195_2272157366429120,3,20,1,24,1.1308
1991716644473195_2272158363095687,1,0,0,1,0.5994
1991716644473195_2272159973095526,0,21,4,25,-1.7944
1991716644473195_2272160399762150,0,4,0,4,0
1991716644473195_2272161209762069,1,1,0,2,0.5994
1991716644473195_2272161416428715,0,5,0,5,0
1991716644473195_2272168699761320,1,1,0,2,0.5994
1991716644473195_2272171959760994,2,0,0,2,0.6039
1991716644473195_2272173836427473,2,2,1,5,0.6299
1991716644473195_2272175886427268,0,9,0,9,0
1991716644473195_2272176923093831,0,11,1,12,-0.4019
1991716644473195_2272189109759279,0,2,0,2,0
1991716644473195_2272193749758815,3,19,3,25,-0.0662
1991716644473195_2272194469758743,1,15,0,16,0.296
1991716644473195_2272213456423511,2,0,0,2,0.9671
1991716644473195_2272214383090085,5,10,1,16,0.4842
1991716644473195_2272215769756613,0,3,0,3,0
1991716644473195_2272222526422604,1,0,0,1,0.5267
1991716644473195_2272222543089269,0,2,0,2,0
1991716644473195_2272225729755617,0,0,1,1,-0.4404
1991716644473195_2272226099755580,1,0,0,1,0.4404
1991716644473195_2272231976421659,0,1,0,1,0
1991716644473195_2272237916421065,1,1,0,2,0.802
1991716644473195_2272238129754377,0,1,0,1,0
1991716644473195_2272238856420971,0,1,0,1,0
1991716644473195_2272239413087582,1,2,0,3,0.6705
1991716644473195_2272241043087419,1,1,0,2,0.0772
1991716644473195_2272242233087300,1,0,0,1,0.5267
1991716644473195_2272242446420612,0,3,0,3,0
1991716644473195_2272242846420572,1,1,0,2,0.5106
1991716644473195_2272243706420486,1,0,0,1,0.5267
1991716644473195_2272249563086567,1,0,0,1,0.5106
1991716644473195_2272251979752992,1,10,0,11,0.34
1991716644473195_2272252163086307,0,2,0,2,0
1991716644473195_2272257923085731,0,1,0,1,0
1991716644473195_2272263993085124,1,2,0,3,0.34
1991716644473195_2272264009751789,4,9,2,15,1.5395
1991716644473195_2272265776418279,1,0,0,1,0.6369
1991716644473195_2272266316418225,0,1,0,1,0
1991716644473195_2272268013084722,0,1,0,1,0
1991716644473195_2272271869751003,4,5,0,9,1.4889
1991716644473195_2272272619750928,2,2,0,4,0.9671
1991716644473195_2272280053083518,0,0,1,1,-0.4767
1991716644473195_2272284533083070,0,2,1,3,-0.504
1991716644473195_2272302966414560,3,6,2,11,0.4596
1991716644473195_2272309213080602,1,2,0,3,0.3089
1991716644473195_2272315399746650,0,1,0,1,0
1991716644473195_2272317599746430,1,0,0,1,0.4404
1991716644473195_2272322203079303,0,2,0,2,0
1991716644473195_2272322563079267,0,1,0,1,0
1991716644473195_2272322999745890,1,9,0,10,0.296
1991716644473195_2272324846412372,1,0,0,1,0.5267
1991716644473195_2272331893078334,1,0,0,1,0.4404
1991716644473195_2272344609743729,0,3,0,3,0
1991716644473195_2272358516409005,1,0,1,2,0.1444
1991716644473195_2272377689740421,1,0,0,1,0.296
1991716644473195_2272409349737255,0,1,0,1,0
1991716644473195_2272426423068881,6,8,0,14,1.886
1991716644473195_2272440266400830,0,1,0,1,0
1991716644473195_2272441309734059,1,0,0,1,0.5994
1991716644473195_2272442199733970,2,0,0,2,0.5176
1991716644473195_2272448603066663,6,15,4,25,1.3171
1991716644473195_2272455249732665,1,6,0,7,0.4926
1991716644473195_2272468233064700,1,5,0,6,0.9136
1991716644473195_2272484923063031,1,2,0,3,0.5267
1991716644473195_2272495249728665,1,2,1,4,0.0222
1991716644473195_2272499666394890,1,0,0,1,0.5267
1991716644473195_2272502036394653,1,1,0,2,0.5267
1991716644473195_2272508609727329,4,0,0,4,2.1051
1991716644473195_2272509663060557,1,2,0,3,0.4404
1991716644473195_2272514903060033,0,1,0,1,0
1991716644473195_2272522003059323,1,1,0,2,0.34
1991716644473195_2272782433033280,0,1,0,1,0
1991716644473195_2272802389697951,3,21,1,25,0.72
1991716644473195_2272814293030094,1,9,1,11,0.4023
1991716644473195_2272815393029984,2,3,0,5,1.4403
1991716644473195_2272823073029216,0,1,0,1,0
1991716644473195_2272843473027176,1,1,0,2,0.9136
1991716644473195_2272857023025821,0,1,0,1,0
1991716644473195_2272857153025808,0,1,0,1,0
1991716644473195_2272861769692013,1,7,2,10,-0.0438
1991716644473195_2272868096358047,0,1,0,1,0
1991716644473195_2272873453024178,2,1,0,3,1.0534
1991716644473195_2272886659689524,0,1,0,1,0
1991716644473195_2272896449688545,2,21,2,25,-0.1447
1991716644473195_2272897619688428,0,1,0,1,0
1991716644473195_2272900029688187,1,1,0,2,0.4939
1991716644473195_2272901026354754,1,5,1,7,0
1991716644473195_2272903373021186,0,1,0,1,0
1991716644473195_2272905509687639,1,3,0,4,0.5267
1991716644473195_2272915319686658,0,1,0,1,0
1991716644473195_2272920756352781,2,5,0,7,1.4167
1991716644473195_2272935173018006,1,0,0,1,0.4019
1991716644473195_2272938649684325,2,0,0,2,0.8808
1991716644473195_2272939333017590,4,4,0,8,2.2694
1991716644473195_2272942853017238,5,1,0,6,3.2385
1991716644473195_2272955776349279,1,3,0,4,0.5267
1991716644473195_2272973326347524,3,7,5,15,-0.4844
1991716644473195_2273023879675802,1,1,0,2,0.5994
1991716644473195_2273054343006089,1,0,0,1,0.8176
1991716644473195_2273067346338122,1,2,0,3,0.2263
1991716644473195_2273075276337329,1,1,0,2,0.6124
1991716644473195_2273079829670207,7,14,1,22,1.4606
1991716644473195_2273192246325632,1,1,0,2,0.9136
1991716644473195_2273254012986122,0,1,0,1,0
1991716644473195_2273288096316047,2,2,0,4,1.4403
1991716644473195_2273289249649265,1,0,0,1,0.9136
1991716644473195_2273304672981056,2,3,0,5,0.8121
1991716644473195_2273572106287646,1,0,0,1,0.2023
1991716644473195_2273619312949592,2,0,0,2,1.4403
1991716644473195_2273675569610633,3,0,0,3,1.8807
1991716644473195_2273681342943389,4,13,6,23,-0.6401
1991716644473195_2273697316275125,1,1,0,2,0.9136
1991716644473195_2273706726274184,1,1,0,2,0.9136
1991716644473195_2273713156273541,2,1,0,3,1.6433
1991716644473195_2273721276272729,5,3,0,8,3.1432
1991716644473195_2273727836272073,8,15,2,25,2.139
1991716644473195_2273732999604890,1,2,0,3,0.6369
1991716644473195_2273736996271157,1,0,0,1,0.9136
1991716644473195_2273737262937797,1,0,0,1,0.9136
1991716644473195_2273738942937629,0,1,0,1,0
1991716644473195_2273760549602135,1,0,0,1,0.9136
1991716644473195_2273775526267304,2,0,0,2,0.8808
1991716644473195_2273783696266487,1,19,5,25,-1.3597
1991716644473195_2273789519599238,8,4,5,17,0.0311
1991716644473195_2273809736263883,2,3,0,5,1.513
1991716644473195_2273813762930147,0,4,1,5,-0.296
1991716644473195_2273842059593984,0,2,0,2,0
1991716644473195_2273852086259648,1,0,0,1,0.9136
1991716644473195_2273866736258183,1,0,0,1,0.4404
1991716644473195_2273882989589891,2,0,0,2,0.9329
1991716644473195_2273886479589542,3,1,0,4,2.0397
1991716644473195_2273920972919426,3,0,0,3,1.3896
1991716644473195_2273922709585919,1,0,1,2,0.6176
1991716644473195_2273940466250810,1,1,0,2,0.891
1991716644473195_2273967209581469,2,1,0,3,1.4403
1991716644473195_2274010859577104,1,2,0,3,0.9136
1991716644473195_2274021296242727,1,0,0,1,0.9136
1991716644473195_2274040672907456,3,1,0,4,1.967
1991716644473195_2274048819573308,2,0,0,2,1.354
1991716644473195_2274366669541523,1,0,0,1,0.4404
1991716644473195_2274380576206799,1,0,0,1,0.9136
1991716644473195_2274412279536962,3,1,0,4,1.8807
1991716644473195_2274422682869255,1,0,0,1,0.9136
1991716644473195_2274427169535473,2,1,0,3,0.9176
1991716644473195_2274472162864307,1,0,0,1,0.9136
1991716644473195_2274485216196335,1,0,0,1,0.9136
1991716644473195_2274485809529609,1,0,0,1,0.932
1991716644473195_2274487792862744,0,1,0,1,0
1991716644473195_2274488406196016,1,0,0,1,0.9136
1991716644473195_2274491429529047,1,0,0,1,0.9136
1991716644473195_2274501649528025,1,0,0,1,0.891
1991716644473195_2274505659527624,11,7,0,18,6.5781
1991716644473195_2274512549526935,2,0,0,2,1.4177
1991716644473195_2274515639526626,1,0,0,1,0.9136
1991716644473195_2274515789526611,1,0,0,1,0.891
1991716644473195_2274517402859783,1,0,0,1,0.9136
1991716644473195_2274533599524830,1,0,0,1,0.9136
1991716644473195_2274544796190377,4,0,0,4,2.9081
1991716644473195_2274545826190274,2,0,0,2,1.4403
1991716644473195_2274552489522941,2,1,0,3,1.2318
1991716644473195_2274553086189548,1,0,0,1,0.9136
1991716644473195_2274559132855610,1,1,0,2,0.891
1991716644473195_2274567212854802,1,0,0,1,0.9136
1991716644473195_2274567406188116,2,1,1,4,0.9576
1991716644473195_2274617486183108,1,0,0,1,0.6847
1991716644473195_2274622379515952,3,2,0,5,2.0171
1991716644473195_2274635349514655,4,1,0,5,2.3848
1991716644473195_2274645259513664,8,15,2,25,3.2719
1991716644473195_2274646749513515,6,13,6,25,0.2637
1991716644473195_2274657169512473,1,1,0,2,0.891
1991716644473195_2274677552843768,1,0,0,1,0.9136
1991716644473195_2274696736175183,3,5,0,8,1.8294
1991716644473195_2274699562841567,2,5,0,7,1.5682
1991716644473195_2274712462840277,1,0,1,2,0.6176
1991716644473195_2274746619503528,1,0,0,1,0.9136
1991716644473195_2274810849497105,1,1,0,2,0.9136
1991716644473195_2274821106162746,1,0,0,1,0.9136
1991716644473195_2274824439495746,0,1,0,1,0
1991716644473195_2274840586160798,2,0,0,2,1.4403
1991716644473195_2274849046159952,2,2,0,4,0.9855
1991716644473195_2274853456159511,1,5,0,6,0.9136
1991716644473195_2274874319490758,3,0,0,3,2.1379
1991716644473195_2274887292822794,3,2,0,5,1.8991
1991716644473195_2274901136154743,3,2,0,5,1.2408
1991716644473195_2274909386153918,1,1,0,2,0.9136
1991716644473195_2275089389469251,2,4,0,6,0.7804
1991716644473195_2275113709466819,1,1,0,2,0.9136
1991716644473195_2275123296132527,1,2,0,3,0.9136
1991716644473195_2275137742797749,2,0,1,3,0.9626
1991716644473195_2275142872797236,0,9,3,12,-1.2171
1991716644473195_2275153916129465,1,0,0,1,0.9136
1991716644473195_2275165772794946,1,0,0,1,0.9136
1991716644473195_2275179256126931,3,1,0,4,1.65
1991716644473195_2275208122790711,1,0,0,1,0.9136
1991716644473195_2275241486120708,0,1,0,1,0
1991716644473195_2275272402784283,1,0,0,1,0.9136
1991716644473195_2275278096117047,1,0,0,1,0.9136
1991716644473195_2275281362783387,2,0,0,2,1.513
1991716644473195_2275291739449016,3,1,0,4,2.0397
1991716644473195_2275316646113192,3,0,0,3,2.3816
1991716644473195_2275355189442671,1,0,0,1,0.9136
1991716644473195_2275369222774601,1,0,0,1,0.9136
1991716644473195_2275375549440635,2,0,0,2,1.7407
1991716644473195_2275382896106567,2,0,0,2,1.354
1991716644473195_2275386152772908,1,1,0,2,0.9136
1991716644473195_2275412896103567,2,0,0,2,1.3724
1991716644473195_2275451316099725,1,0,0,1,0.8175
1991716644473195_2275476252763898,1,0,0,1,0.9136
1991716644473195_2275480152763508,3,0,0,3,1.8709
1991716644473195_2275538062757717,1,1,0,2,0.9136
1991716644473195_2275586996086157,1,0,0,1,0.8175
1991716644473195_2275590306085826,1,0,0,1,0.6808
1991716644473195_2275622256082631,1,1,0,2,0.7269
1991716644473195_2275870516057805,3,0,0,3,1.6479
1991716644473195_2276005376044319,1,2,0,3,0.34
1991716644473195_2276026249375565,1,0,0,1,0.8175
1991716644473195_2276070339371156,1,1,0,2,0.4019
1991716644473195_2276213102690213,0,1,0,1,0
1991716644473195_2276274162684107,1,0,0,1,0.8175
1991716644473195_2276303019347888,1,0,0,1,0.872
1991716644473195_2276348679343322,1,1,0,2,0.5994
1991716644473195_2276388192672704,4,10,0,14,1.2483
1991716644473195_2276463019331888,3,0,0,3,1.7342
1991716644473195_2276790182632505,1,1,0,2,0.5267
1991716644473195_2276806262630897,1,0,0,1,0.4404
1991716644473195_2276845302626993,1,0,0,1,0.4404
1991716644473195_2277007269277463,2,4,0,6,0.6119
1991716644473195_2277015689276621,1,2,0,3,0.4404
1991716644473195_2277080465936810,0,1,0,1,0
1991716644473195_2277452079232982,1,14,4,19,-1.167
1991716644473195_2277527722558751,0,0,1,1,-0.644
1991716644473195_2277536549224535,1,0,0,1,0.8175
1991716644473195_2277548345890022,1,0,0,1,0.6808
1991716644473195_2277557829222407,0,1,0,1,0
1991716644473195_2277560202555503,3,11,8,22,-1.7634
1991716644473195_2277560249222165,3,0,0,3,1.6983
1991716644473195_2277566952554828,5,0,0,5,2.8078
1991716644473195_2277626345882222,1,0,0,1,0.9136
1991716644473195_2277646552546868,1,0,0,1,0.9136
1991716644473195_2277661442545379,1,0,0,1,0.9136
1991716644473195_2277679472543576,3,1,1,5,1.0145
1991716644473195_2277686169209573,2,0,0,2,1.3724
1991716644473195_2277708135874043,2,1,0,3,1.2318
1991716644473195_2277718729206317,3,0,0,3,1.8015
1991716644473195_2277741445870712,2,2,0,4,0.9908
1991716644473195_2277754232536100,1,0,0,1,0.5267
1991716644473195_2277769879201202,2,1,0,3,1.0147
1991716644473195_2277951382516385,0,8,0,8,0
1991716644473195_2277965255848331,4,0,0,4,2.66
1991716644473195_2277985795846277,1,0,0,1,0.9382
1991716644473195_2277990202512503,0,2,1,3,-0.4019
1991716644473195_2277991525845704,1,3,1,5,0.1444
1991716644473195_2277992075845649,0,1,1,2,-0.4019
1991716644473195_2277992402512283,3,11,6,20,-1.4629
1991716644473195_2278021295842727,1,0,0,1,0.9382
1991716644473195_2278231172488406,1,5,2,8,-0.7936
1991716644473195_2278272939150896,1,0,0,1,0.9382
1991716644473195_2278280622483461,1,2,0,3,0.9382
1991716644473195_2278291142482409,1,1,0,2,0.9382
1991716644473195_2278316279146562,1,0,0,1,0.9382
1991716644473195_2278318722479651,2,0,0,2,1.3597
1991716644473195_2278336992477824,1,0,0,1,0.9382
1991716644473195_2278372442474279,0,2,0,2,0
1991716644473195_2278439175800939,3,1,0,4,1.1839
1991716644473195_2278441239134066,0,3,0,3,0
1991716644473195_2278489102462613,1,3,0,4,0.4404
1991716644473195_2278496515795205,0,1,0,1,0
1991716644473195_2278613089116881,0,0,2,2,-0.7727
1991716644473195_2278635119114678,1,0,0,1,0.9136
1991716644473195_2278660889112101,2,0,0,2,1.4403
1991716644473195_2278697832441740,1,2,0,3,0.9136
1991716644473195_2278713435773513,1,1,0,2,0.9136
1991716644473195_2278739599104230,3,1,0,4,1.7998
1991716644473195_2278793472432176,1,0,0,1,0.9136
1991716644473195_2278811745763682,0,1,0,1,0
1991716644473195_2279056349072555,2,0,1,3,1.1443
1991716644473195_2279081382403385,1,0,0,1,0.9136
1991716644473195_2279081835736673,1,1,1,3,0.3475
1991716644473195_2279094345735422,1,0,0,1,0.9136
1991716644473195_2279106532400870,1,0,0,1,0.9136
1991716644473195_2279112555733601,1,0,0,1,0.9136
1991716644473195_2279126305732226,1,0,0,1,0.9136
1991716644473195_2279135189064671,1,0,0,1,0.6486
1991716644473195_2279148872396636,2,0,0,2,0.9482
1991716644473195_2279160955728761,2,0,0,2,1.2575
1991716644473195_2279162535728603,4,1,0,5,2.2761
1991716644473195_2279189515725905,8,3,0,11,3.9559
1991716644473195_2279190385725818,2,4,0,6,0.9908
1991716644473195_2279190485725808,1,0,0,1,0.9136
1991716644473195_2279195565725300,1,0,0,1,0.9136
1991716644473195_2279218952389628,1,0,0,1,0.9136
1991716644473195_2279230835721773,1,0,0,1,0.9136
1991716644473195_2279236922387831,1,0,0,1,0.802
1991716644473195_2279239212387602,1,0,0,1,0.802
1991716644473195_2279241192387404,2,0,0,2,1.2096
1991716644473195_2279247469053443,0,2,0,2,0
1991716644473195_2279269019051288,1,0,0,1,0.802
1991716644473195_2279284895716367,8,1,0,9,3.8865
1991716644473195_2279288205716036,1,0,0,1,0.802
1991716644473195_2279291532382370,1,0,0,1,0.802
1991716644473195_2279294072382116,1,0,0,1,0.802
1991716644473195_2279304065714450,1,0,0,1,0.802
1991716644473195_2279415285703328,15,0,0,15,6.3627
1991716644473195_2279424022369121,4,0,0,4,2.2419
1991716644473195_2279447705700086,2,0,0,2,1.4403
1991716644473195_2279462732365250,1,0,0,1,0.9136
1991716644473195_2279500429028147,1,0,0,1,0.9136
1991716644473195_2279510229027167,1,1,0,2,0.9136
1991716644473195_2279510755693781,1,0,0,1,0.9136
1991716644473195_2279529722358551,1,0,0,1,0.9382
1991716644473195_2279531622358361,2,0,0,2,1.2954
1991716644473195_2279532649024925,1,0,0,1,0.9382
1991716644473195_2279570112354512,2,0,0,2,1.4403
1991716644473195_2279577575687099,1,1,0,2,0.9136
1991716644473195_2279594309018759,1,0,0,1,0.9136
1991716644473195_2279597552351768,1,1,0,2,0.9136
1991716644473195_2279602215684635,1,4,0,5,0.9136
1991716644473195_2279610725683784,3,0,0,3,1.7152
1991716644473195_2279800198998170,2,1,0,3,1.354
1991716644473195_2279836778994512,1,0,0,1,0.9136
1991716644473195_2279837045661152,1,0,0,1,0.9136
1991716644473195_2279841138994076,6,2,0,8,3.5199
1991716644473195_2279855505659306,2,0,0,2,1.3724
1991716644473195_2279881272323396,1,0,0,1,0.9136
1991716644473195_2279882605656596,1,0,0,1,0.9136
1991716644473195_2279888568989333,0,1,0,1,0
1991716644473195_2279898672321656,1,0,0,1,0.4215
1991716644473195_2279899172321606,1,0,0,1,0.9929
1991716644473195_2279923082319215,1,0,0,1,0.9382
1991716644473195_2279943412317182,1,0,0,1,0.9382
1991716644473195_2279944818983708,2,1,0,3,1.0398
1991716644473195_2279953218982868,0,1,0,1,0
1991716644473195_2279978008980389,1,0,0,1,0.9382
1991716644473195_2279987802312743,1,10,0,11,0.3182
1991716644473195_2280070438971146,1,0,0,1,0.9382
1991716644473195_2280089385635918,1,0,0,1,0.9382
1991716644473195_2280272615617595,1,0,0,1,0.9382
1991716644473195_2280289792282544,1,0,1,2,0.7357
1991716644473195_2280303988947791,1,0,0,1,0.9136
1991716644473195_2280304495614407,1,0,0,1,0.9136
1991716644473195_2280313775613479,1,0,0,1,0.9136
1991716644473195_2280323522279171,3,0,0,3,1.7152
1991716644473195_2280413685603488,11,0,0,11,5.7161
1991716644473195_2280619115582945,1,1,1,3,0.5117
1991716644473195_2280659472245576,2,0,0,2,1.4075
1991716644473195_2280709575573899,1,0,0,1,0.9136
1991716644473195_2280711548907035,1,0,0,1,0.9136
1991716644473195_2280712902240233,2,0,1,3,0.9957
1991716644473195_2280716258906564,1,0,0,1,0.9136
1991716644473195_2280730372238486,4,0,0,4,2.3938
1991716644473195_2280739398904250,2,0,0,2,1.354
1991716644473195_2280767178901472,1,0,0,1,0.9136
1991716644473195_2280770822234441,2,2,1,5,1.217
1991716644473195_2280789415565915,2,0,0,2,1.513
1991716644473195_2280791468899043,1,0,0,1,0.9136
1991716644473195_2280813995563457,1,0,0,1,0.9136
1991716644473195_2280841275560729,13,6,1,20,6.8141
1991716644473195_2280867155558141,2,0,0,2,1.3351
1991716644473195_2280870492224474,1,0,0,1,0.9136
1991716644473195_2280872845557572,2,0,0,2,1.4995
1991716644473195_2280873658890824,1,0,0,1,0.9136
1991716644473195_2280881128890077,1,0,0,1,0.9136
1991716644473195_2280882115556645,2,0,0,2,1.354
1991716644473195_2280904092221114,0,0,1,1,-0.4019
1991716644473195_2280960128882177,3,0,0,3,2.1308
1991716644473195_2280961752215348,24,1,0,25,12.2317
1991716644473195_2280966835548173,1,0,0,1,0.9136
1991716644473195_2280979345546922,1,0,0,1,0.9136
1991716644473195_2281000412211482,1,3,0,4,0.9062
1991716644473195_2281045678873622,1,0,0,1,0.9136
1991716644473195_2281093822202141,1,0,0,1,0.9136
1991716644473195_2281115882199935,2,0,0,2,1.4075
1991716644473195_2281133645531492,2,0,0,2,1.3597
1991716644473195_2281134598864730,2,0,0,2,1.4403
1991716644473195_2281419042169619,5,3,0,8,3.1387
1991716644473195_2281437545501102,2,0,0,2,1.513
1991716644473195_2281454398832750,2,0,0,2,1.2022
1991716644473195_2281474358830754,1,0,0,1,0.9382
1991716644473195_2281482422163281,2,0,0,2,1.0816
1991716644473195_2281484122163111,0,1,1,2,-0.5994
1991716644473195_2281490465495810,1,0,0,1,0.9136
1991716644473195_2281493168828873,5,3,2,10,0.2425
1991716644473195_2281620165482840,15,3,0,18,7.3687
1991716644473195_2281649345479922,1,4,2,7,0.151
1991716644473195_2281656915479165,1,0,0,1,0.9062
1991716644473195_2281664828811707,1,1,0,2,0.9136
1991716644473195_2281669008811289,1,1,0,2,0.9136
1991716644473195_2281671988810991,1,0,0,1,0.9136
1991716644473195_2281700662141457,1,0,0,1,0.9136
1991716644473195_2281713288806861,0,1,0,1,0
1991716644473195_2281750745469782,1,0,0,1,0.9136
1991716644473195_2281753002136223,3,5,1,9,1.0586
1991716644473195_2281767305468126,1,0,0,1,0.9136
1991716644473195_2282289265415930,16,3,0,19,8.7111
1991716644473195_2282331632078360,1,2,0,3,0.9136
1991716644473195_2282367205408136,1,0,0,1,0.4215
1991716644473195_2282524252059098,2,1,0,3,0.9671
1991716644473195_2282721975372659,2,0,0,2,1.513
1991716644473195_2282989048679285,2,0,0,2,0.8808
1991716644473195_2283073878670802,1,0,0,1,0.9136
1991716644473195_2283113142000209,5,0,0,5,2.4424
1991716644473195_2283161658662024,2,1,0,3,1.2096
1991716644473195_2283182681993255,1,1,0,2,0.9136
1991716644473195_2283184001993123,1,1,0,2,0.9136
1991716644473195_2283210835323773,1,0,0,1,0.9136
1991716644473195_2283217841989739,1,0,0,1,0.9136
1991716644473195_2283222478655942,1,0,0,1,0.9136
1991716644473195_2283264865318370,1,1,0,2,0.34
1991716644473195_2283286835316173,1,1,0,2,0.7506
1991716644473195_2283305601980963,3,3,1,7,1.1747
1991716644473195_2283354741976049,3,2,0,5,1.3735
1991716644473195_2283364128641777,1,0,0,1,0.5994
1991716644473195_2283450638633126,0,1,0,1,0
1991716644473195_2283455241965999,0,1,0,1,0
1991716644473195_2283457105299146,2,1,0,3,0.7837
1991716644473195_2283749468603243,1,0,0,1,0.6597
1991716644473195_2283755688602621,0,4,0,4,0
1991716644473195_2283776338600556,7,2,0,9,3.8256
1991716644473195_2283810851930438,3,0,0,3,1.3562
1991716644473195_2283818075263049,3,1,0,4,1.4289
1991716644473195_2283821325262724,2,0,0,2,1.4378
1991716644473195_2283842061927317,1,0,0,1,0.4404
1991716644473195_2283852775259579,1,0,0,1,0.5267
1991716644473195_2283932195251637,2,0,0,2,0.9331
1991716644473195_2283942728583917,5,2,0,7,2.4199
1991716644473195_2283992815245575,7,2,0,9,3.7917
1991716644473195_2284013405243516,2,17,1,20,0.3791
1991716644473195_2284025858575604,7,0,0,7,3.9873
1991716644473195_2284030755241781,1,4,1,6,-0.2628
1991716644473195_2284086425236214,2,0,0,2,1.0398
1991716644473195_2284133685231488,1,0,0,1,0.8922
1991716644473195_2284243001887223,1,0,0,1,0.8922
1991716644473195_2284462318531958,0,1,0,1,0
1991716644473195_2284509885193868,2,0,0,2,1.2873
1991716644473195_2284512605193596,1,1,0,2,0.4404
1991716644473195_2284549368523253,1,3,0,4,0.8922
1991716644473195_2284573228520867,2,1,0,3,1.2629
1991716644473195_2284578568520333,3,0,0,3,1.8609
1991716644473195_2284579478520242,1,0,0,1,0.8922
1991716644473195_2284623818515808,0,1,0,1,0
1991716644473195_2284639521847571,3,1,0,4,1.3357
1991716644473195_2284640631847460,13,10,2,25,6.9043
1991716644473195_2284688621842661,2,3,0,5,1.1003
1991716644473195_2284729415171915,1,1,0,2,0.8415
1991716644473195_2284756481835875,1,0,0,1,0.4754
1991716644473195_2284760558502134,0,2,0,2,0
1991716644473195_2284845371826986,16,9,0,25,7.68
1991716644473195_2284865728491617,1,0,0,1,0.4215
1991716644473195_2284915495153307,2,1,0,3,1.0653
1991716644473195_2285012545143602,21,4,0,25,10.62
1991716644473195_2285205885124268,5,2,0,7,2.1642
1991716644473195_2285230211788502,23,2,0,25,10.221
1991716644473195_2285234448454745,1,0,0,1,0.3818
1991716644473195_2285269525117904,2,8,2,12,-0.1628
1991716644473195_2285270748451115,0,2,0,2,0
1991716644473195_2285302271781296,2,0,0,2,0.8069
1991716644473195_2285331395111717,3,0,0,3,1.3212
1991716644473195_2285337595111097,12,2,0,14,6.2395
1991716644473195_2285342818443908,1,0,0,1,0.6249
1991716644473195_2285366465108210,1,1,0,2,0.4404
1991716644473195_2285374088440781,6,0,0,6,2.7493
1991716644473195_2285377031773820,5,1,0,6,2.4319
1991716644473195_2285392155105641,1,2,0,3,0.7501
1991716644473195_2285429945101862,2,0,0,2,0.8808
1991716644473195_2285456965099160,3,0,0,3,1.2834
1991716644473195_2285465378431652,3,0,0,3,1.4258
1991716644473195_2285541388424051,3,6,2,11,0.4621
1991716644473195_2285596171751906,5,0,0,5,2.3418
1991716644473195_2285645268413663,3,0,0,3,1.2834
1991716644473195_2285666101744913,6,0,0,6,3.2455
1991716644473195_2285670788411111,3,2,0,5,1.6427
1991716644473195_2285701828408007,3,1,0,4,1.3735
1991716644473195_2285717631739760,0,1,0,1,0
1991716644473195_2285984361713087,1,0,0,1,0.6369
1991716644473195_2286010778377112,1,1,0,2,0.4404
1991716644473195_2286016231709900,1,0,0,1,0.4927
1991716644473195_2286031558375034,10,14,1,25,4.0244
1991716644473195_2286046688373521,19,3,0,22,8.8169
1991716644473195_2286050028373187,9,11,5,25,1.8962
1991716644473195_2286081425036714,3,0,0,3,1.2943
1991716644473195_2286090705035786,1,0,0,1,0.5994
1991716644473195_2286097655035091,2,0,0,2,0.8969
1991716644473195_2286131155031741,1,0,0,1,0.4404
1991716644473195_2286133921698131,2,2,0,4,1.3001
1991716644473195_2286141258364064,1,1,0,2,0.6369
1991716644473195_2286143738363816,9,0,0,9,4.7244
1991716644473195_2286145438363646,1,1,0,2,0.4404
1991716644473195_2286145968363593,1,1,0,2,0.4215
1991716644473195_2286147808363409,5,1,0,6,2.4335
1991716644473195_2286152738362916,5,0,0,5,1.997
1991716644473195_2286155748362615,2,0,0,2,1.1582
1991716644473195_2286156195029237,4,0,0,4,2.3356
1991716644473195_2286165291694994,9,2,0,11,4.809
1991716644473195_2286175525027304,3,0,0,3,1.4193
1991716644473195_2286176171693906,3,2,0,5,1.4988
1991716644473195_2286182558359934,0,1,0,1,0
1991716644473195_2286193428358847,1,0,0,1,0.6369
1991716644473195_2286207078357482,1,0,0,1,0.4404
1991716644473195_2286215991689924,14,4,0,18,7.4563
1991716644473195_2286229158355274,20,4,1,25,10.223
1991716644473195_2286232085021648,1,0,0,1,0.6369
1991716644473195_2286243881687135,1,0,0,1,0.4404
1991716644473195_2286265855018271,1,0,0,1,0.6369
1991716644473195_2286280395016817,1,2,0,3,0.4754
1991716644473195_2286283778349812,6,0,0,6,2.7636
1991716644473195_2286293581682165,17,8,0,25,7.8529
1991716644473195_2286309631680560,1,0,0,1,0.6369
1991716644473195_2286313581680165,1,0,0,1,0.9382
1991716644473195_2286326871678836,2,0,0,2,1.1003
1991716644473195_2286363965008460,3,1,0,4,1.4988
1991716644473195_2286364168341773,1,0,0,1,0.6369
1991716644473195_2286377731673750,1,0,0,1,0.6369
1991716644473195_2286393865005470,1,0,0,1,0.5106
1991716644473195_2286394171672106,1,0,0,1,0.4215
1991716644473195_2286443835000473,4,0,0,4,1.7427
1991716644473195_2286445858333604,3,0,0,3,1.4424
1991716644473195_2286450278333162,5,0,0,5,2.1264
1991716644473195_2286660868312103,2,0,0,2,1.0773
1991716644473195_2286729731638550,7,1,0,8,3.2593
1991716644473195_2286787834966073,1,0,0,1,0.6369
1991716644473195_2286800258298164,1,0,0,1,0.6369
1991716644473195_2286833978294792,1,0,0,1,0.6369
1991716644473195_2286848134960043,1,1,0,2,0.4215
1991716644473195_2286859071625616,2,0,0,2,0.8619
1991716644473195_2286860561625467,3,0,0,3,1.6458
1991716644473195_2286897248288465,2,0,0,2,1.2224
1991716644473195_2286912848286905,7,0,0,7,3.7411
1991716644473195_2287014404943416,1,0,0,1,0.4215
1991716644473195_2287138718264318,14,5,0,19,7.8353
1991716644473195_2287195264925330,3,0,0,3,1.5338
1991716644473195_2287519454892911,8,4,2,14,2.3048
1991716644473195_2287538248224365,15,9,1,25,7.8857
1991716644473195_2287729398205250,12,11,2,25,6.0774
1991716644473195_2288276678150522,2,0,0,2,0.8808
1991716644473195_2288332638144926,1,1,0,2,0.6369
1991716644473195_2288336851477838,1,0,0,1,0.4215
1991716644473195_2288341871477336,2,0,0,2,1.6118
1991716644473195_2288342764810580,1,0,0,1,0.6369
1991716644473195_2288381344806722,9,0,0,9,4.8531
1991716644473195_2288383778139812,7,2,0,9,3.2535
1991716644473195_2288387184806138,2,0,0,2,1.0773
1991716644473195_2288393028138887,2,0,0,2,1.0773
1991716644473195_2288415171470006,2,1,0,3,0.9158
1991716644473195_2288416168136573,1,1,0,2,0.6369
1991716644473195_2288449554799901,5,7,1,13,1.4598
1991716644473195_2288454681466055,2,1,0,3,1.0773
1991716644473195_2288455441465979,1,0,0,1,0.6369
1991716644473195_2288455874799269,1,1,0,2,0.4927
1991716644473195_2288459324798924,7,5,1,13,2.6655
1991716644473195_2288532148124975,23,2,0,25,11.8585
1991716644473195_2288551104789746,4,0,0,4,1.9556
1991716644473195_2288560288122161,1,1,0,2,0.34
1991716644473195_2288622421449281,16,4,1,21,7.7552
1991716644473195_2288640614780795,14,9,1,24,6.3343
1991716644473195_2288664431445080,5,4,0,9,1.8738
1991716644473195_2288671734777683,4,0,0,4,2.2891
1991716644473195_2288730574771799,5,0,0,5,2.17
1991716644473195_2288932244751632,11,1,1,13,5.4571
1991716644473195_2289065198071670,1,0,0,1,0.4927
1991716644473195_2289122164732640,9,2,0,11,4.0659
1991716644473195_2289124724732384,2,0,0,2,0.964
1991716644473195_2289135048064685,16,3,0,19,8.1997
1991716644473195_2289139404730916,1,0,0,1,0.4404
1991716644473195_2289148808063309,1,0,0,1,0.4215
1991716644473195_2289150781396445,1,0,0,1,0.4404
1991716644473195_2289221468056043,1,1,0,2,0.0772
1991716644473195_2289221611389362,2,2,0,4,0.8619
1991716644473195_2289229484721908,0,2,0,2,0
1991716644473195_2289231734721683,12,0,0,12,6.2079
1991716644473195_2289234184721438,0,1,0,1,0
1991716644473195_2289246014720255,1,2,0,3,0.4404
1991716644473195_2289248451386678,2,0,0,2,1.0133
1991716644473195_2289290841382439,3,8,0,11,1.139
1991716644473195_2289300381381485,0,3,0,3,0
1991716644473195_2289336488044541,1,0,0,1,0.6249
1991716644473195_2289356638042526,1,0,0,1,0.4404
1991716644473195_2289357281375795,1,0,0,1,0.4404
1991716644473195_2289368528041337,5,0,0,5,2.202
1991716644473195_2289373184707538,2,0,0,2,0.8808
1991716644473195_2289401634704693,2,1,0,3,0.8619
1991716644473195_2289426581368865,2,0,0,2,0.8808
1991716644473195_2289445444700312,3,0,0,3,1.154
1991716644473195_2289458344699022,3,0,0,3,1.7695
1991716644473195_2289490861362437,9,5,0,14,3.3956
1991716644473195_2289528964691960,16,2,0,18,7.0638
1991716644473195_2289529614691895,1,0,0,1,0.3612
1991716644473195_2289559418022248,3,0,0,3,1.4613
1991716644473195_2289833727994817,1,0,0,1,0.54
1991716644473195_2289840224660834,0,2,0,2,0
1991716644473195_2289889617989228,14,1,0,15,6.0958
1991716644473195_2289908747987315,1,0,0,1,0.4404
1991716644473195_2289915261319997,2,1,0,3,0.8808
1991716644473195_2289933414651515,2,0,0,2,1.1109
1991716644473195_2289955201316003,1,0,0,1,0.4019
1991716644473195_2289959274648929,3,0,0,3,1.2834
1991716644473195_2289959997982190,9,4,0,13,4.2714
1991716644473195_2289967994648057,3,0,0,3,1.4667
1991716644473195_2289978631313660,7,0,0,7,3.625
1991716644473195_2289989254645931,2,1,0,3,1.1864
1991716644473195_2289994824645374,1,0,0,1,0.4404
1991716644473195_2289996301311893,0,1,0,1,0
1991716644473195_2290008021310721,1,0,0,1,0.4404
1991716644473195_2290014854643371,2,0,0,2,0.8808
1991716644473195_2290021831309340,3,0,0,3,1.8125
1991716644473195_2290041164640740,4,0,0,4,2.1627
1991716644473195_2290045971306926,8,2,0,10,3.4244
1991716644473195_2290060254638831,3,0,0,3,1.6458
1991716644473195_2290060537972136,8,0,0,8,4.6611
1991716644473195_2290076587970531,1,1,0,2,0.4754
1991716644473195_2290163261295197,2,0,0,2,0.8619
1991716644473195_2290179404626916,4,0,0,4,1.8151
1991716644473195_2290185064626350,4,1,0,5,2.4653
1991716644473195_2290190041292519,23,2,0,25,10.3593
1991716644473195_2290196044625252,1,0,0,1,0.4404
1991716644473195_2290227344622122,4,0,0,4,1.9272
1991716644473195_2290254357952754,2,1,1,4,0.9021
1991716644473195_2290264367951753,0,1,0,1,0
1991716644473195_2290266481284875,5,0,0,5,2.3335
1991716644473195_2290324304612426,1,0,0,1,0.4404
1991716644473195_2290393231272200,1,0,0,1,0.4404
1991716644473195_2290398814604975,1,0,0,1,0.6369
1991716644473195_2290401871271336,1,0,0,1,0.4404
1991716644473195_2290430494601807,2,0,0,2,1.3029
1991716644473195_2290450217933168,1,0,0,1,0.6369
1991716644473195_2290453751266148,15,4,0,19,8.1611
1991716644473195_2290711631240360,4,0,0,4,1.8662
1991716644473195_2290737444571112,1,0,0,1,0.6369
1991716644473195_2290741164570740,15,4,0,19,6.8058
1991716644473195_2290747581236765,1,0,0,1,0.4927
1991716644473195_2290764437901746,4,1,0,5,1.954
1991716644473195_2290768884567968,6,0,0,6,2.9674
1991716644473195_2290791457899044,10,1,0,11,4.9501
1991716644473195_2290797847898405,0,0,1,1,-0.0258
1991716644473195_2290808251230698,9,3,0,12,3.9447
1991716644473195_2290810711230452,3,0,0,3,1.8442
1991716644473195_2290817614563095,5,0,0,5,2.237
1991716644473195_2290827564562100,1,0,0,1,0.4215
1991716644473195_2290828221228701,3,3,1,7,1.6227
1991716644473195_2290831837895006,4,3,0,7,2.996
1991716644473195_2290833691228154,1,0,0,1,0.7184
1991716644473195_2290836324561224,10,5,0,15,5.3127
1991716644473195_2290837541227769,10,0,0,10,5.5107
1991716644473195_2290850341226489,20,1,0,21,9.8192
1991716644473195_2290868627891327,2,0,0,2,0.8619
1991716644473195_2290876191223904,0,1,0,1,0
1991716644473195_2290887981222725,2,0,0,2,0.9331
1991716644473195_2290930657885124,2,1,0,3,1.0123
1991716644473195_2290960387882151,2,0,0,2,0.843
1991716644473195_2290967441214779,22,1,0,23,10.9788
1991716644473195_2290976377880552,1,0,0,1,0.4404
1991716644473195_2290982817879908,2,0,0,2,0.8619
1991716644473195_2291013211210202,1,0,0,1,0.4404
1991716644473195_2291020887876101,19,4,0,23,9.7121
1991716644473195_2291054104539446,4,2,0,6,2.4926
1991716644473195_2291181151193408,1,0,0,1,0.4404
1991716644473195_2291448477833342,8,0,0,8,4.3762
1991716644473195_2291454157832774,1,0,0,1,0.5994
1991716644473195_2291457421165781,0,1,0,1,0
1991716644473195_2291462407831949,2,1,0,3,0.8808
1991716644473195_2291470747831115,3,0,0,3,1.3212
1991716644473195_2291478137830376,3,2,0,5,1.3023
1991716644473195_2291478564497000,1,0,0,1,0.4754
1991716644473195_2291483887829801,1,0,0,1,0.4404
1991716644473195_2291508161160707,21,4,0,25,9.6041
1991716644473195_2291515821159941,6,0,0,6,3.0099
1991716644473195_2291522157825974,2,1,0,3,1.0921
1991716644473195_2291528084492048,1,0,0,1,0.4215
1991716644473195_2291541441157379,2,0,0,2,0.9343
1991716644473195_2291544917823698,8,6,1,15,2.7227
1991716644473195_2291559931155530,15,0,1,16,6.6401
1991716644473195_2291563284488528,1,4,0,5,0.4404
1991716644473195_2291564024488454,1,0,0,1,0.4404
1991716644473195_2291572044487652,6,0,0,6,2.6046
1991716644473195_2291573257820864,4,0,0,4,2.0396
1991716644473195_2291573554487501,15,1,0,16,7.436
1991716644473195_2291584144486442,1,0,0,1,0.4404
1991716644473195_2291640797814110,21,4,0,25,11.3331
1991716644473195_2291647381146785,6,0,0,6,3.2091
1991716644473195_2291660951145428,5,0,0,5,2.1257
1991716644473195_2291678631143660,8,0,0,8,4.0373
1991716644473195_2291687517809438,1,0,0,1,0.8415
1991716644473195_2291692991142224,3,0,0,3,1.2843
1991716644473195_2291706364474220,8,0,0,8,4.195
1991716644473195_2291707434474113,9,0,1,10,4.3118
1991716644473195_2291710654473791,1,0,0,1,0.4754
1991716644473195_2291740617804128,12,11,2,25,5.9391
1991716644473195_2291744847803705,2,1,0,3,0.7887
1991716644473195_2291781084466748,1,1,0,2,0.4404
1991716644473195_2291784081133115,11,1,0,12,6.505
1991716644473195_2291786627799527,3,0,0,3,1.3212
1991716644473195_2291810544463802,0,1,0,1,0
1991716644473195_2291826827795507,2,0,0,2,0.8619
1991716644473195_2292093251102198,1,0,0,1,0.4215
1991716644473195_2292098471101676,3,0,0,3,1.5616
1991716644473195_2292118404433016,13,1,0,14,6.4989
1991716644473195_2292192074425649,2,4,0,6,0.9394
1991716644473195_2292206494424207,9,4,0,13,5.4482
1991716644473195_2292209321090591,2,0,0,2,1.0748
1991716644473195_2292235087754681,1,0,0,1,0.4404
1991716644473195_2292243204420536,2,0,0,2,1.0398
1991716644473195_2292259377752252,4,0,0,4,2.1574
1991716644473195_2292273991084124,2,0,0,2,0.9158
1991716644473195_2292350574409799,1,1,0,2,0.91
1991716644473195_2292395017738688,8,0,0,8,3.6547
1991716644473195_2292397737738416,6,1,0,7,3.0841
1991716644473195_2292399987738191,6,1,0,7,3.4443
1991716644473195_2292400797738110,15,4,0,19,7.1791
1991716644473195_2292495087728681,4,1,0,5,1.7611
1991716644473195_2292513497726840,1,0,0,1,0.4215
1991716644473195_2292561997721990,1,0,0,1,0.4404
1991716644473195_2292563424388514,1,1,0,2,0.4404
1991716644473195_2292808617697328,8,1,0,9,3.5204
1991716644473195_2292851891026334,2,0,0,2,0.9331
1991716644473195_2292898271021696,20,3,2,25,8.9692
1991716644473195_2292904731021050,1,0,0,1,0.3818
1991716644473195_2292914257686764,0,2,0,2,0
1991716644473195_2292929251018598,2,0,0,2,0.7786
1991716644473195_2292930344351822,24,1,0,25,12.0258
1991716644473195_2292955094349347,5,1,0,6,2.3286
1991716644473195_2293001174344739,16,4,0,20,8.7354
1991716644473195_2293001227678067,1,0,0,1,0.5994
1991716644473195_2293073351004188,5,0,0,5,2.2893
1991716644473195_2293123717665818,8,1,0,9,4.3546
1991716644473195_2293130354331821,2,0,0,2,0.9331
1991716644473195_2293163497661840,5,0,0,5,2.3073
1991716644473195_2293212064323650,2,0,0,2,1.3956
1991716644473195_2293550764289780,4,1,0,5,2.1388
1991716644473195_2293630270948496,3,0,0,3,1.2834
1991716644473195_2293698044275052,2,2,0,4,0.8808
1991716644473195_2293705927607597,12,1,0,13,6.1159
1991716644473195_2293710490940474,3,1,0,4,1.6585
1991716644473195_2293715370939986,8,0,0,8,3.6888
1991716644473195_2293724537605736,7,0,0,7,3.425
1991716644473195_2293725697605620,4,1,0,5,1.795
1991716644473195_2293729247605265,9,2,0,11,4.5842
1991716644473195_2293734054271451,1,0,0,1,0.4404
1991716644473195_2293752194269637,2,0,0,2,0.8808
1991716644473195_2293755214269335,2,0,0,2,0.9331
1991716644473195_2293758510935672,2,0,0,2,0.9331
1991716644473195_2293794407598749,1,1,0,2,0.4404
1991716644473195_2293798754264981,4,2,0,6,1.9206
1991716644473195_2293813554263501,3,0,0,3,1.5177
1991716644473195_2293813997596790,6,4,1,11,2.1649
1991716644473195_2293814294263427,1,0,0,1,0.4404
1991716644473195_2293815007596689,5,1,0,6,2.1453
1991716644473195_2293816704263186,2,1,0,3,1.214
1991716644473195_2293818370929686,1,1,0,2,0.4404
1991716644473195_2293823497595840,7,2,0,9,3.3572
1991716644473195_2293823560929167,2,0,0,2,0.8808
1991716644473195_2293823794262477,1,0,0,1,0.4404
1991716644473195_2293825727595617,2,0,0,2,0.8808
1991716644473195_2293827734262083,1,0,0,1,0.4404
1991716644473195_2293829104261946,1,0,0,1,0.4939
1991716644473195_2293831870928336,1,0,0,1,0.4404
1991716644473195_2293832810928242,2,0,0,2,0.8619
1991716644473195_2293839294260927,2,0,0,2,0.8619
1991716644473195_2293839764260880,2,1,0,3,0.9537
1991716644473195_2293840920927431,1,0,0,1,0.4404
1991716644473195_2293841330927390,5,1,0,6,2.6482
1991716644473195_2293841870927336,1,0,0,1,0.4404
1991716644473195_2293842417593948,1,1,0,2,0.4404
1991716644473195_2293847527593437,1,0,0,1,0.4404
1991716644473195_2293849630926560,3,1,0,4,0.8881
1991716644473195_2293850910926432,2,0,0,2,0.5176
1991716644473195_2293851467593043,13,1,0,14,6.6181
1991716644473195_2293852794259577,1,1,0,2,0.4404
1991716644473195_2293853574259499,3,0,0,3,1.3212
1991716644473195_2293857284259128,1,0,0,1,0.4404
1991716644473195_2293858577592332,2,0,0,2,0.8808
1991716644473195_2293870250924498,1,0,0,1,0.4404
1991716644473195_2293876020923921,1,0,0,1,0.4404
1991716644473195_2293883190923204,2,0,0,2,0.9158
1991716644473195_2293889140922609,1,0,0,1,0.4404
1991716644473195_2293892830922240,2,0,0,2,0.8808
1991716644473195_2293907477587442,3,0,0,3,1.3023
1991716644473195_2293945467583643,7,0,0,7,3.9909
1991716644473195_2293952820916241,1,0,0,1,0.4404
1991716644473195_2293954970916026,1,0,0,1,0.4215
1991716644473195_2293987144246142,1,0,0,1,0.5994
1991716644473195_2293989117579278,4,2,0,6,2.1627
1991716644473195_2293995564245300,1,2,0,3,0.6249
1991716644473195_2293998960911627,1,1,0,2,0.4215
1991716644473195_2294003364244520,3,0,0,3,1.4802
1991716644473195_2294011010910422,9,4,0,13,3.8672
1991716644473195_2294019324242924,1,0,0,1,0.9694
1991716644473195_2294021057576084,1,0,0,1,0.4939
1991716644473195_2294021430909380,2,0,0,2,0.8808
1991716644473195_2294053064239550,19,2,0,21,9.1108
1991716644473195_2294064534238403,5,2,0,7,2.3676
1991716644473195_2294076427570547,25,0,0,25,11.8846
1991716644473195_2294078390903684,12,6,0,18,5.1826
1991716644473195_2294240270887496,1,0,0,1,0.4404
1991716644473195_2294323430879180,3,1,0,4,1.8469
1991716644473195_2294330414211815,3,0,0,3,1.3735
1991716644473195_2294341540877369,0,1,0,1,0
1991716644473195_2294342747543915,1,0,0,1,0.4404
1991716644473195_2294350417543148,2,0,0,2,0.8808
1991716644473195_2294355357542654,21,4,0,25,11.4809
1991716644473195_2294357980875725,3,0,0,3,2.1005
1991716644473195_2294358380875685,1,0,0,1,0.4404
1991716644473195_2294404787537711,1,1,0,2,0.34
1991716644473195_2294405410870982,3,1,0,4,1.3212
1991716644473195_2294420994202757,1,0,0,1,0.4404
1991716644473195_2294421330869390,2,0,0,2,1.2054
1991716644473195_2294431027535087,2,0,0,2,0.8808
1991716644473195_2294442380867285,1,0,0,1,0.4404
1991716644473195_2294443747533815,5,0,0,5,2.3286
1991716644473195_2294447874200069,2,0,0,2,0.9158
1991716644473195_2294448370866686,24,1,0,25,10.912
1991716644473195_2294451174199739,2,0,0,2,0.9331
1991716644473195_2294453467532843,2,0,0,2,1.1801
1991716644473195_2294454510866072,1,0,0,1,0.4404
1991716644473195_2294460574198799,1,0,0,1,0.4404
1991716644473195_2294463840865139,2,0,0,2,1.0773
1991716644473195_2294470694197787,1,0,0,1,0.4404
1991716644473195_2294471510864372,4,1,0,5,1.6446
1991716644473195_2294490497529140,2,1,0,3,1.0398
1991716644473195_2294492384195618,2,0,0,2,1.0398
1991716644473195_2294493284195528,1,0,0,1,0.4404
1991716644473195_2294493457528844,2,1,0,3,1.3807
1991716644473195_2294493657528824,1,0,0,1,0.4404
1991716644473195_2294499114194945,1,0,0,1,0.4404
1991716644473195_2294502984194558,5,0,0,5,2.202
1991716644473195_2294503454194511,4,0,0,4,2.0334
1991716644473195_2294505410860982,1,0,0,1,0.4404
1991716644473195_2294511747527015,1,0,0,1,0.4404
1991716644473195_2294515774193279,1,0,0,1,0.4404
1991716644473195_2294519374192919,3,1,0,4,1.5325
1991716644473195_2294528324192024,1,0,0,1,0.4404
1991716644473195_2294532460858277,2,1,0,3,0.8808
1991716644473195_2294541370857386,2,0,0,2,0.8808
1991716644473195_2294546230856900,17,0,0,17,8.0316
1991716644473195_2294549750856548,2,0,0,2,1.3949
1991716644473195_2294558114189045,1,0,0,1,0.4404
1991716644473195_2294558710855652,6,0,0,6,2.747
1991716644473195_2294559070855616,2,2,0,4,0.8619
1991716644473195_2294563020855221,1,0,0,1,0.4404
1991716644473195_2294563924188464,3,0,0,3,1.4802
1991716644473195_2294580964186760,0,1,0,1,0
1991716644473195_2294586507519539,1,0,0,1,0.4404
1991716644473195_2294593144185542,6,1,0,7,2.1811
1991716644473195_2294595670851956,10,6,0,16,4.7927
1991716644473195_2294613360850187,1,0,0,1,0.6249
1991716644473195_2294613760850147,1,0,0,1,0.4404
1991716644473195_2294614107516779,0,1,0,1,0
1991716644473195_2294616150849908,1,1,0,2,0.25
1991716644473195_2294621357516054,1,0,0,1,0.4927
1991716644473195_2294622430849280,3,1,0,4,1.3184
1991716644473195_2294626740848849,3,1,0,4,1.5169
1991716644473195_2294627064182150,1,0,0,1,0.4215
1991716644473195_2294636060847917,1,0,0,1,0.4404
1991716644473195_2294639650847558,16,1,0,17,8.1812
1991716644473195_2294655127512677,2,1,0,3,0.8619
1991716644473195_2294668207511369,2,0,0,2,0.9783
1991716644473195_2294669347511255,7,0,0,7,3.2764
1991716644473195_2294669830844540,9,1,0,10,3.9403
1991716644473195_2294675637510626,23,2,0,25,14.289
1991716644473195_2294683737509816,1,0,0,1,0.6249
1991716644473195_2294689037509286,1,0,0,1,0.4404
1991716644473195_2294696547508535,6,0,0,6,3.2022
1991716644473195_2294702550841268,4,0,0,4,1.9931
1991716644473195_2294703434174513,2,0,0,2,0.8016
1991716644473195_2294703787507811,1,0,0,1,0.8415
1991716644473195_2294716197506570,1,0,0,1,0.4404
1991716644473195_2294726127505577,1,1,0,2,0.4404
1991716644473195_2294759730835550,3,0,0,3,1.3212
1991716644473195_2294765637501626,7,1,0,8,3.177
1991716644473195_2294953370816186,1,0,0,1,0.4404
1991716644473195_2294955410815982,1,0,0,1,0.4404
1991716644473195_2294978114147045,4,1,0,5,2.1051
1991716644473195_2295007900810733,22,3,0,25,12.7869
1991716644473195_2295009800810543,1,0,0,1,0.4404
1991716644473195_2295018654142991,5,1,0,6,2.1831
1991716644473195_2295021690809354,1,0,0,1,0.4404
1991716644473195_2295021814142675,1,1,0,2,0.4404
1991716644473195_2295030564141800,1,0,0,1,0.4404
1991716644473195_2295040014140855,1,1,2,4,-0.2704
1991716644473195_2295073734137483,3,0,0,3,1.3212
1991716644473195_2295106894134167,6,0,0,6,2.808
1991716644473195_2295108704133986,1,0,0,1,0.4404
1991716644473195_2295112034133653,1,0,0,1,0.4404
1991716644473195_2295129917465198,1,1,0,2,0.4404
1991716644473195_2295135374131319,1,0,0,1,0.4404
1991716644473195_2295136000797923,2,0,0,2,1.4664
1991716644473195_2295137927464397,1,0,0,1,0.4404
1991716644473195_2295151894129667,2,0,0,2,0.898
1991716644473195_2295156430795880,7,0,0,7,3.2832
1991716644473195_2295156924129164,0,1,0,1,0
1991716644473195_2295157254129131,2,0,0,2,0.8808
1991716644473195_2295177657460424,10,1,0,11,5.0683
1991716644473195_2295183820793141,2,0,0,2,0.843
1991716644473195_2295190317459158,8,15,2,25,3.5357
1991716644473195_2295196160791907,22,3,0,25,11.6714
1991716644473195_2295210730790450,4,0,0,4,1.8639
1991716644473195_2295213857456804,1,1,0,2,0.4404
1991716644473195_2295225170789006,1,0,0,1,0.4404
1991716644473195_2295229184121938,1,0,0,1,0.4404
1991716644473195_2295231310788392,7,0,0,7,3.0072
1991716644473195_2295235047454685,1,0,0,1,0.4404
1991716644473195_2295254770786046,1,0,0,1,0.4404
1991716644473195_2295260300785493,1,0,0,1,0.4404
1991716644473195_2295260897452100,9,0,0,9,4.702
1991716644473195_2295264570785066,6,1,0,7,3.2012
1991716644473195_2295279274116929,4,2,0,6,1.5168
1991716644473195_2295280990783424,3,0,0,3,1.3735
1991716644473195_2295281044116752,1,0,0,1,0.4404
1991716644473195_2295285964116260,1,0,0,1,0.4215
1991716644473195_2295297347448455,1,1,0,2,0.4404
1991716644473195_2295299697448220,5,0,0,5,2.5847
1991716644473195_2295299794114877,1,0,0,1,0.4404
1991716644473195_2295301904114666,1,0,0,1,0.4404
1991716644473195_2295304917447698,2,0,0,2,1.0992
1991716644473195_2295315077446682,3,0,0,3,1.3023
1991716644473195_2295315367446653,4,0,0,4,1.7427
1991716644473195_2295318617446328,4,0,0,4,1.9794
1991716644473195_2295328710778652,1,0,0,1,0.4404
1991716644473195_2295329634111893,1,1,0,2,0.4404
1991716644473195_2295336024111254,2,0,0,2,0.9158
1991716644473195_2295346817443508,1,0,0,1,0.4404
1991716644473195_2295357947442395,5,1,0,6,2.1831
1991716644473195_2295361147442075,1,0,0,1,0.4404
1991716644473195_2295363134108543,1,0,0,1,0.4404
1991716644473195_2295364650775058,1,0,0,1,0.4404
1991716644473195_2295364937441696,3,0,0,3,1.3373
1991716644473195_2295365067441683,2,0,0,2,1.0398
1991716644473195_2295378367440353,2,0,0,2,0.8619
1991716644473195_2295389294105927,2,0,0,2,1.2306
1991716644473195_2295404347437755,1,0,0,1,0.4404
1991716644473195_2295566810754842,1,0,0,1,0.4404
1991716644473195_2295584854086371,2,0,0,2,0.8016
1991716644473195_2295592264085630,5,0,0,5,2.3636
1991716644473195_2295614114083445,1,0,0,1,0.4404
1991716644473195_2295618984082958,4,0,0,4,1.7049
1991716644473195_2295620224082834,2,0,0,2,0.8808
1991716644473195_2295621337416056,1,1,0,2,0.4404
1991716644473195_2295622670749256,2,0,0,2,0.8619
1991716644473195_2295623277415862,4,1,0,5,1.7238
1991716644473195_2295633680748155,3,1,0,4,1.4828
1991716644473195_2295635627414627,8,2,0,10,3.7787
1991716644473195_2295649614079895,1,0,0,1,0.4404
1991716644473195_2295650644079792,2,0,0,2,0.8808
1991716644473195_2295668037411386,0,1,0,1,0
1991716644473195_2295684314076425,19,5,1,25,8.8166
1991716644473195_2295692774075579,1,0,0,1,0.4404
1991716644473195_2295715184073338,1,0,0,1,0.4404
1991716644473195_2295729314071925,2,1,0,3,1.1744
1991716644473195_2295738524071004,5,1,0,6,2.2704
1991716644473195_2295751937402996,1,1,0,2,0.7951
1991716644473195_2295770924067764,1,0,0,1,0.4404
1991716644473195_2295772710734252,3,0,0,3,1.5057
1991716644473195_2295774257400764,4,0,0,4,1.5755
1991716644473195_2295838490727674,4,0,0,4,1.9083
1991716644473195_2295840030727520,19,1,0,20,9.4992
1991716644473195_2295843094060547,3,0,0,3,1.4802
1991716644473195_2295869047391285,2,1,0,3,0.9158
1991716644473195_2295869500724573,1,0,0,1,0.4404
1991716644473195_2295871014057755,19,6,0,25,10.2832
1991716644473195_2295885344056322,1,0,0,1,0.4215
1991716644473195_2295897414055115,2,1,0,3,0.8619
1991716644473195_2295903227387867,4,1,0,5,1.9848
1991716644473195_2295904600721063,2,0,0,2,0.8619
1991716644473195_2295906600720863,10,5,0,15,5.8043
1991716644473195_2295910470720476,2,0,0,2,0.9158
1991716644473195_2295914397386750,5,2,0,7,2.5924
1991716644473195_2295915600719963,1,0,0,1,0.8519
1991716644473195_2295917767386413,1,0,0,1,0.4215
1991716644473195_2295924554052401,1,0,0,1,0.4404
1991716644473195_2295925044052352,2,0,0,2,0.8808
1991716644473195_2295949964049860,1,1,0,2,0.4404
1991716644473195_2295966087381581,1,2,0,3,0.5994
1991716644473195_2295968007381389,7,4,0,11,3.0957
1991716644473195_2295977310713792,4,1,0,5,1.7131
1991716644473195_2295979797380210,2,1,0,3,0.8619
1991716644473195_2296009284043928,2,0,0,2,1.229
1991716644473195_2296022657375924,1,0,0,1,0.4404
1991716644473195_2296032164041640,2,0,0,2,0.8808
1991716644473195_2296063597371830,3,0,0,3,1.6591
1991716644473195_2296063764038480,4,0,0,4,1.989
1991716644473195_2296065720704951,1,0,0,1,0.7269
1991716644473195_2296082344036622,2,0,0,2,0.8808
1991716644473195_2296305314014325,7,0,0,7,3.8673
1991716644473195_2296349887343201,4,0,0,4,2.0308
1991716644473195_2296352840676239,3,0,0,3,1.3184
1991716644473195_2296362524008604,5,1,0,6,2.1831
1991716644473195_2296369830674540,2,0,0,2,0.8619
1991716644473195_2296374547340735,1,1,0,2,0.4927
1991716644473195_2296378104007046,1,0,0,1,0.4404
1991716644473195_2296382094006647,3,0,0,3,1.5405
1991716644473195_2296388807339309,2,0,0,2,0.8808
1991716644473195_2296420140669509,2,0,0,2,0.8619
1991716644473195_2296439167334273,3,0,0,3,1.3373
1991716644473195_2296444490667074,3,2,0,5,1.4096
1991716644473195_2296444994000357,15,6,4,25,6.2692
1991716644473195_2296450963999760,1,0,0,1,0.4927
1991716644473195_2296451230666400,3,1,0,4,1.3747
1991716644473195_2296454063999450,23,2,0,25,11.0288
1991716644473195_2296457100665813,8,2,0,10,3.3873
1991716644473195_2296467363998120,19,2,0,21,8.8927
1991716644473195_2296490693995787,1,0,0,1,0.4215
1991716644473195_2296490823995774,3,0,0,3,1.2042
1991716644473195_2296491880662335,1,0,0,1,0.4404
1991716644473195_2296501390661384,2,0,0,2,0.8619
1991716644473195_2296516820659841,1,0,0,1,0.4404
1991716644473195_2296532597324930,1,0,0,1,0.4404
1991716644473195_2296534693991387,1,0,0,1,0.4404
1991716644473195_2296536620657861,3,0,0,3,1.3562
1991716644473195_2296539363990920,1,0,0,1,0.658
1991716644473195_2296548100656713,1,0,0,1,0.4404
1991716644473195_2296550427323147,6,1,0,7,3.2309
1991716644473195_2296553650656158,9,2,0,11,4.2078
1991716644473195_2296554290656094,6,1,0,7,3.1071
1991716644473195_2296567890654734,6,0,0,6,2.6919
1991716644473195_2296568770654646,1,0,0,1,0.4215
1991716644473195_2296569697321220,2,0,0,2,0.8969
1991716644473195_2296574320654091,1,0,0,1,0.4215
1991716644473195_2296579447320245,3,0,0,3,1.4893
1991716644473195_2296587650652758,1,0,0,1,0.4404
1991716644473195_2296602407317949,2,1,0,3,0.8619
1991716644473195_2296607550650768,8,1,0,9,4.2907
1991716644473195_2296609100650613,1,0,0,1,0.4215
1991716644473195_2296610367317153,1,0,0,1,0.4404
1991716644473195_2296611890650334,6,1,0,7,2.6235
1991716644473195_2296612587316931,24,0,1,25,12.2079
1991716644473195_2296626437315546,22,3,0,25,11.5544
1991716644473195_2296629673981889,20,2,0,22,8.9802
1991716644473195_2296647133980143,6,1,0,7,3.0177
1991716644473195_2296662880645235,1,0,0,1,0.4404
1991716644473195_2296665427311647,1,1,0,2,0.4404
1991716644473195_2296677257310464,5,2,0,7,2.5801
1991716644473195_2296681383976718,3,0,0,3,1.2834
1991716644473195_2296686697309520,1,1,0,2,0.4404
1991716644473195_2296689753975881,3,1,0,4,1.8353
1991716644473195_2296691443975712,1,1,0,2,0.4404
1991716644473195_2296712660640257,4,2,0,6,1.9795
1991716644473195_2296715880639935,7,1,0,8,3.5686
1991716644473195_2296722677305922,1,1,0,2,0.4404
1991716644473195_2296725470638976,3,0,0,3,1.6336
1991716644473195_2296754567302733,18,3,0,21,8.6644
1991716644473195_2296758970635626,2,0,0,2,0.843
1991716644473195_2297005510610972,1,0,0,1,0.4404
1991716644473195_2297018437276346,17,8,0,25,8.758
1991716644473195_2297023647275825,1,0,0,1,0.4215
1991716644473195_2297051003939756,1,0,0,1,0.765
1991716644473195_2297093653935491,8,2,0,10,3.6875
1991716644473195_2297097887268401,9,3,0,12,4.5136
1991716644473195_2297104807267709,3,1,0,4,1.5057
1991716644473195_2297105580600965,1,0,0,1,0.4404
1991716644473195_2297112097266980,1,0,0,1,0.4754
1991716644473195_2297133870598136,1,0,0,1,0.4404
1991716644473195_2297135370597986,1,0,0,1,0.4404
1991716644473195_2297138700597653,1,0,0,1,0.4404
1991716644473195_2297144013930455,5,0,0,5,2.2543
1991716644473195_2297150000596523,3,0,0,3,1.4791
1991716644473195_2297157667262423,2,1,0,3,0.9331
1991716644473195_2297160003928856,13,1,0,14,6.0356
1991716644473195_2297194377258752,1,0,0,1,0.8591
1991716644473195_2297233647254825,1,0,0,1,0.4404
1991716644473195_2297242740587249,1,0,0,1,0.4404
1991716644473195_2297259957252194,1,0,0,1,0.5622
1991716644473195_2297279320583591,1,0,0,1,0.4404
1991716644473195_2297306373914219,5,2,0,7,2.6326
1991716644473195_2297336800577843,2,0,0,2,0.8808
1991716644473195_2297382740573249,2,0,0,2,0.7136
1991716644473195_2297630003881856,2,0,0,2,0.8808
1991716644473195_2297643713880485,0,1,0,1,0
1991716644473195_2297672863877570,1,0,0,1,0.4404
1991716644473195_2297688350542688,2,0,0,2,0.9158
1991716644473195_2297728277205362,11,0,0,11,5.1699
1991716644473195_2297747283870128,2,0,0,2,0.9331
1991716644473195_2297753107202879,1,1,0,2,0.4404
1991716644473195_2297797843865072,1,0,0,1,0.4404
1991716644473195_2297801153864741,1,0,0,1,0.4404
1991716644473195_2297862310525292,5,0,0,5,2.6381
1991716644473195_2297872247190965,1,0,0,1,0.4404
1991716644473195_2297903650521158,4,0,0,4,1.5829
1991716644473195_2297919980519525,3,1,0,4,1.3212
1991716644473195_2297928427185347,2,0,0,2,0.9804
1991716644473195_2297968457181344,2,0,0,2,1.0653
1991716644473195_2298078607170329,1,0,0,1,0.5719
1991716644473195_2298080207170169,4,0,0,4,2.1471
1991716644473195_2298093403835516,18,0,1,19,8.6705
1991716644473195_2298373927140797,2,0,0,2,0.8808
1991716644473195_2298375427140647,9,0,0,9,4.5951
1991716644473195_2298393533805503,4,0,0,4,1.9083
1991716644473195_2298393670472156,6,1,0,7,2.755
1991716644473195_2298398123805044,3,1,0,4,1.2558
1991716644473195_2298453183799538,5,0,0,5,2.237
1991716644473195_2298468530464670,3,0,0,3,1.3212
1991716644473195_2298479587130231,1,0,0,1,0.4215
1991716644473195_2298481203796736,14,3,0,17,6.693
1991716644473195_2298485253796331,1,0,0,1,0.4404
1991716644473195_2298520420459481,1,0,0,1,0.4754
1991716644473195_2298524340459089,3,1,0,4,1.5169
1991716644473195_2298527513792105,2,0,0,2,0.8808
1991716644473195_2298537257124464,2,0,0,2,0.8808
1991716644473195_2298538227124367,2,2,0,4,0.843
1991716644473195_2298545960456927,2,3,0,5,0.8808
1991716644473195_2298553450456178,4,0,0,4,1.7616
1991716644473195_2298554443789412,9,2,0,11,4.5344
1991716644473195_2298564693788387,1,0,0,1,0.4404
1991716644473195_2298568863787970,9,0,0,9,4.7607
1991716644473195_2298570747121115,4,1,0,5,2.0481
1991716644473195_2298578307120359,0,2,0,2,0
1991716644473195_2298579817120208,1,0,0,1,0.4215
1991716644473195_2298584523786404,4,2,0,6,1.7427
1991716644473195_2298587537119436,1,1,0,2,0.4927
1991716644473195_2298590953785761,9,0,0,9,4.7595
1991716644473195_2298598940451629,1,0,0,1,0.4404
1991716644473195_2298612487116941,1,1,0,2,0.4404
1991716644473195_2298613370450186,1,0,0,1,0.4404
1991716644473195_2298616333783223,3,0,0,3,1.4478
1991716644473195_2298636530447870,1,0,0,1,0.2732
1991716644473195_2298639817114208,4,0,0,4,2.1459
1991716644473195_2298641897114000,6,2,0,8,3.6586
1991716644473195_2298643747113815,2,0,0,2,1.0653
1991716644473195_2298654927112697,1,1,0,2,0.9329
1991716644473195_2298669467111243,4,2,0,6,2.292
1991716644473195_2298724570439066,1,0,0,1,0.4404
1991716644473195_2298761800435343,2,0,0,2,0.9171
1991716644473195_2298984973746359,1,0,0,1,0.4404
1991716644473195_2299009117077278,8,0,0,8,3.9604
1991716644473195_2299009563743900,2,0,0,2,0.8808
1991716644473195_2299022943742562,1,0,0,1,0.4404
1991716644473195_2299034050408118,8,1,0,9,4.3023
1991716644473195_2299038087074381,4,0,0,4,1.7616
1991716644473195_2299038247074365,4,1,0,5,2.5161
1991716644473195_2299045667073623,2,0,0,2,0.5176
1991716644473195_2299064007071789,20,5,0,25,9.3979
1991716644473195_2299080387070151,0,1,0,1,0
1991716644473195_2299086053736251,2,0,0,2,0.8808
1991716644473195_2299090077069182,1,3,0,4,0.34
1991716644473195_2299091197069070,0,1,0,1,0
1991716644473195_2299093833735473,13,1,0,14,8.2948
1991716644473195_2299094847068705,18,1,0,19,8.9005
1991716644473195_2299112607066929,2,1,0,3,1.0263
1991716644473195_2299116793733177,2,0,0,2,0.9331
1991716644473195_2299118197066370,2,0,0,2,1.2675
1991716644473195_2299131787065011,2,0,0,2,0.9343
1991716644473195_2299134187064771,1,0,0,1,0.4404
1991716644473195_2299136450397878,6,0,0,6,2.6585
1991716644473195_2299141527064037,1,1,0,2,0.4404
1991716644473195_2299146657063524,1,0,0,1,0.4404
1991716644473195_2299148973729959,0,2,0,2,0
1991716644473195_2299150680396455,3,2,0,5,1.8687
1991716644473195_2299162320395291,5,1,0,6,2.7339
1991716644473195_2299174080394115,5,0,0,5,2.3146
1991716644473195_2299177050393818,1,0,0,1,0.4404
1991716644473195_2299182927059897,6,0,0,6,2.6235
1991716644473195_2299182970393226,5,0,0,5,2.6553
1991716644473195_2299188780392645,0,1,0,1,0
1991716644473195_2299213000390223,1,0,0,1,0.4404
1991716644473195_2299216930389830,3,2,0,5,0.9391
1991716644473195_2299226593722197,20,1,0,21,10.2515
1991716644473195_2299237070387816,0,2,0,2,0
1991716644473195_2299239533720903,3,1,0,4,1.7707
1991716644473195_2299242233720633,6,0,0,6,2.6424
1991716644473195_2299243767053813,4,0,0,4,1.8139
1991716644473195_2299246947053495,0,1,0,1,0
1991716644473195_2299247570386766,2,0,0,2,0.8619
1991716644473195_2299260387052151,5,0,0,5,2.6003
1991716644473195_2299263700385153,4,0,0,4,1.7427
1991716644473195_2299291667049023,2,0,0,2,0.9331
1991716644473195_2299292470382276,7,2,0,9,3.5591
1991716644473195_2299292563715600,5,1,0,6,2.1992
1991716644473195_2299292757048914,3,0,0,3,1.7242
1991716644473195_2299321943712662,1,0,0,1,0.4404
1991716644473195_2299335790377944,1,0,0,1,0.4404
1991716644473195_2299341493710707,1,0,0,1,0.5994
1991716644473195_2299350430376480,1,0,0,1,0.4215
1991716644473195_2299353360376187,3,0,0,3,1.277
1991716644473195_2299367863708070,1,0,0,1,0.4404
1991716644473195_2299375750373948,7,3,0,10,4.2618
1991716644473195_2299377863707070,9,1,0,10,4.1055
1991716644473195_2299387333706123,2,0,0,2,1.0123
1991716644473195_2299416580369865,2,1,0,3,1.0263
1991716644473195_2299619497016240,2,0,0,2,0.8969
1991716644473195_2299659283678928,3,0,0,3,1.4338
1991716644473195_2299667967011393,6,0,0,6,3.4998
1991716644473195_2299672893677567,1,0,0,1,0.4404
1991716644473195_2299691687009021,2,0,0,2,1.3949
1991716644473195_2299702120341311,9,1,0,10,4.0725
1991716644473195_2299753607002829,1,0,0,1,0.5859
1991716644473195_2299756647002525,0,1,0,1,0
1991716644473195_2299770537001136,1,0,0,1,0.4404
1991716644473195_2299770630334460,12,3,0,15,6.4515
1991716644473195_2299783550333168,0,1,0,1,0
1991716644473195_2299783746999815,2,0,0,2,0.8619
1991716644473195_2299795020332021,7,0,0,7,3.5486
1991716644473195_2299799820331541,3,0,0,3,1.4662
1991716644473195_2299801010331422,1,0,0,1,0.4404
1991716644473195_2299804520331071,1,0,0,1,0.4215
1991716644473195_2299807390330784,3,0,0,3,1.3184
1991716644473195_2299816446996545,1,0,0,1,0.4404
1991716644473195_2299828603661996,3,0,0,3,1.4405
1991716644473195_2299831420328381,11,1,0,12,5.6313
1991716644473195_2299832326994957,1,1,0,2,0.4404
1991716644473195_2299834260328097,4,1,0,5,2.4341
1991716644473195_2299846340326889,1,1,0,2,0.4754
1991716644473195_2299846676993522,3,0,0,3,1.154
1991716644473195_2299851196993070,8,0,1,9,3.9185
1991716644473195_2299879293656927,2,0,0,2,0.9142
1991716644473195_2299881840323339,3,0,0,3,1.4085
1991716644473195_2299882800323243,0,2,0,2,0
1991716644473195_2299887910322732,3,0,0,3,1.994
1991716644473195_2299897683655088,4,0,0,4,1.8139
1991716644473195_2299897986988391,3,1,0,4,1.3212
1991716644473195_2299900263654830,5,0,0,5,2.2543
1991716644473195_2299903853654471,12,1,0,13,6.9441
1991716644473195_2299918796986310,4,3,0,7,2.6123
1991716644473195_2299923483652508,7,1,0,8,3.9114
1991716644473195_2299933390318184,10,4,1,15,4.0143
1991716644473195_2299933466984843,5,0,0,5,2.4894
1991716644473195_2299935266984663,1,1,0,2,0.4404
1991716644473195_2299950930316430,1,0,0,1,0.4404
1991716644473195_2299958100315713,3,0,0,3,1.6027
1991716644473195_2299959986982191,1,1,0,2,0.2732
1991716644473195_2300005086977681,6,1,0,7,2.6424
1991716644473195_2300013096976880,8,0,0,8,4.1946
1991716644473195_2300030666975123,15,3,0,18,7.2498
1991716644473195_2300033146974875,1,1,0,2,0.4754
1991716644473195_2300035136974676,1,0,0,1,0.4404
1991716644473195_2300050083639848,5,0,0,5,2.6869
1991716644473195_2300055466972643,1,0,0,1,0.4404
1991716644473195_2300073770304146,4,1,0,5,1.7777
1991716644473195_2300116236966566,9,0,0,9,3.9797
1991716644473195_2300280473616809,5,0,0,5,2.1
1991716644473195_2300361636942026,10,0,0,10,4.3746
1991716644473195_2300407776937412,3,1,0,4,1.8164
1991716644473195_2300412150270308,2,0,0,2,0.8619
1991716644473195_2300414823603374,3,0,0,3,1.2834
1991716644473195_2300415156936674,2,0,0,2,0.8619
1991716644473195_2300434480268075,1,0,0,1,0.4404
1991716644473195_2300448530266670,1,0,0,1,0.4404
1991716644473195_2300452520266271,3,1,0,4,1.2834
1991716644473195_2300455903599266,23,2,0,25,11.9539
1991716644473195_2300461356932054,7,2,0,9,3.7159
1991716644473195_2300462786931911,11,1,0,12,5.3881
1991716644473195_2300482853596571,2,1,0,3,0.8619
1991716644473195_2300504363594420,6,1,0,7,2.8138
1991716644473195_2300506610260862,2,0,0,2,0.8808
1991716644473195_2300507066927483,2,0,0,2,0.8808
1991716644473195_2300513130260210,8,1,0,9,5.0534
1991716644473195_2300515986926591,2,0,0,2,0.8808
1991716644473195_2300543800257143,14,2,0,16,7.157
1991716644473195_2300545276923662,1,0,0,1,0.4404
1991716644473195_2300545410256982,1,0,0,1,0.4404
1991716644473195_2300553436922846,4,0,0,4,1.9272
1991716644473195_2300555560255967,1,0,0,1,0.4404
1991716644473195_2300558623588994,5,0,0,5,2.4261
1991716644473195_2300567200254803,0,1,0,1,0
1991716644473195_2300575570253966,6,2,0,8,3.0426
1991716644473195_2300577620253761,2,0,0,2,1.0464
1991716644473195_2300578646920325,5,0,3,8,2.0284
1991716644473195_2300579930253530,13,3,0,16,7.1076
1991716644473195_2300581486920041,1,1,0,2,0.6249
1991716644473195_2300592706918919,1,1,0,2,0.2732
1991716644473195_2300595646918625,1,0,0,1,0.4215
1991716644473195_2300599236918266,0,1,0,1,0
1991716644473195_2300603096917880,4,0,0,4,1.7049
1991716644473195_2300605450250978,5,0,0,5,2.2771
1991716644473195_2300614530250070,5,0,0,5,2.6045
1991716644473195_2300615533583303,9,2,0,11,4.0914
1991716644473195_2300616640249859,2,0,0,2,0.9142
1991716644473195_2300624786915711,1,0,0,1,0.4404
1991716644473195_2300644126913777,1,9,1,11,0.2141
1991716644473195_2300648296913360,2,0,0,2,0.8619
1991716644473195_2300660583578798,2,1,0,3,0.8619
1991716644473195_2300666193578237,1,0,0,1,0.4404
1991716644473195_2300692593575597,3,0,0,3,1.6105
1991716644473195_2300709406907249,2,0,0,2,0.8619
1991716644473195_2300718786906311,3,0,0,3,1.3023
1991716644473195_2300720273572829,1,0,0,1,0.4215
1991716644473195_2300721163572740,3,0,0,3,1.6201
1991716644473195_2300729233571933,2,0,0,2,0.8016
1991716644473195_2300732086904981,12,0,0,12,6.3385
1991716644473195_2300733910238132,0,1,0,1,0
1991716644473195_2300735503571306,1,0,0,1,0.4927
1991716644473195_2300739820237541,2,0,0,2,0.8619
1991716644473195_2300750263569830,17,3,0,20,7.9804
1991716644473195_2300778116900378,1,0,0,1,0.4215
1991716644473195_2300967143548142,11,4,0,15,5.7749
1991716644473195_2300992366878953,13,3,0,16,6.736
1991716644473195_2301018043543052,2,2,1,5,1.0819
1991716644473195_2301025943542262,0,1,0,1,0
1991716644473195_2301035653541291,4,0,0,4,2.7525
1991716644473195_2301048476873342,3,0,0,3,1.7223
1991716644473195_2301059763538880,9,1,0,10,4.9256
1991716644473195_2301122440199279,2,1,0,3,1.0398
1991716644473195_2301128380198685,2,0,0,2,0.8808
1991716644473195_2301141776864012,2,0,0,2,0.8808
1991716644473195_2301154086862781,18,1,0,19,8.787
1991716644473195_2301154826862707,18,1,0,19,8.9848
1991716644473195_2301156756862514,9,0,0,9,3.923
1991716644473195_2301161596862030,1,0,0,1,0.4404
1991716644473195_2301162783528578,2,0,0,2,0.8808
1991716644473195_2301188260192697,6,0,0,6,3.582
1991716644473195_2301203646857825,2,0,0,2,1.3949
1991716644473195_2301205466857643,2,0,0,2,0.8808
1991716644473195_2301210700190453,5,2,0,7,2.1992
1991716644473195_2301214353523421,15,1,0,16,7.0081
1991716644473195_2301227076855482,2,0,0,2,0.8808
1991716644473195_2301235533521303,2,1,0,3,0.7804
1991716644473195_2301243696853820,1,0,0,1,0.4215
1991716644473195_2301251546853035,3,0,0,3,1.7223
1991716644473195_2301257946852395,2,0,0,2,0.8619
1991716644473195_2301258056852384,0,2,0,2,0
1991716644473195_2301262413518615,1,0,0,1,0.4404
1991716644473195_2301266000184923,2,0,0,2,0.8619
1991716644473195_2301271766851013,4,0,0,4,2.0862
1991716644473195_2301282580183265,3,0,0,3,1.4802
1991716644473195_2301284840183039,2,0,0,2,0.8808
1991716644473195_2301287593516097,2,0,0,2,0.9331
1991716644473195_2301288793515977,1,0,0,1,0.4404
1991716644473195_2301289986849191,4,0,0,4,1.7588
1991716644473195_2301295760181947,3,0,0,3,1.0895
1991716644473195_2301296076848582,1,0,0,1,0.4404
1991716644473195_2301297846848405,4,0,0,4,1.3984
1991716644473195_2301300480181475,18,7,0,25,9.8891
1991716644473195_2301300763514780,1,0,0,1,0.4404
1991716644473195_2301302553514601,3,0,0,3,1.2771
1991716644473195_2301314133513443,10,3,0,13,5.3004
1991716644473195_2301320060179517,1,0,0,1,0.4404
1991716644473195_2301321023512754,1,0,0,1,0.4404
1991716644473195_2301327883512068,2,0,0,2,1.0653
1991716644473195_2301328283512028,2,2,0,4,0.8619
1991716644473195_2301329476845242,1,0,0,1,0.4404
1991716644473195_2301331560178367,7,1,0,8,3.7034
1991716644473195_2301336556844534,4,1,0,5,2.201
1991716644473195_2301339336844256,4,1,0,5,1.7777
1991716644473195_2301339563510900,4,0,0,4,1.6824
1991716644473195_2301339653510891,2,2,0,4,1.3504
1991716644473195_2301344406843749,4,0,0,4,1.9384
1991716644473195_2301351933509663,3,0,0,3,1.2834
1991716644473195_2301353783509478,6,4,0,10,2.5818
1991716644473195_2301359963508860,2,4,0,6,1.0653
1991716644473195_2301379393506917,14,6,5,25,5.028
1991716644473195_2301386753506181,3,0,0,3,1.3023
1991716644473195_2301388080172715,3,1,0,4,1.3562
1991716644473195_2301389290172594,5,0,0,5,2.2889
1991716644473195_2301391506839039,1,0,0,1,0.4404
1991716644473195_2301393756838814,1,0,0,1,0.4404
1991716644473195_2301394343505422,6,0,0,6,3.0002
1991716644473195_2301395950171928,8,8,1,17,3.7563
1991716644473195_2301409046837285,3,0,0,3,1.7034
1991716644473195_2301419763502880,2,0,0,2,1.0653
1991716644473195_2301421336836056,3,0,0,3,1.6844
1991716644473195_2301427596835430,1,0,0,1,0.4404
1991716644473195_2301433470168176,1,0,0,1,0.8415
1991716644473195_2301435016834688,19,0,0,19,10.4572
1991716644473195_2301441316834058,2,0,0,2,0.8016
1991716644473195_2301441673500689,1,1,0,2,0.4215
1991716644473195_2301453273499529,1,0,0,1,0.4404
1991716644473195_2301467226831467,4,0,0,4,1.9017
1991716644473195_2301643403480516,2,0,0,2,1.263
1991716644473195_2301675726810617,1,1,0,2,0.4404
1991716644473195_2301680096810180,5,0,0,5,2.7961
1991716644473195_2301728080138715,7,1,0,8,3.586
1991716644473195_2301746183470238,4,2,0,6,2.2379
1991716644473195_2301746516803538,4,0,0,4,2.1306
1991716644473195_2301759136802276,3,0,0,3,1.4802
1991716644473195_2301767856801404,8,0,0,8,3.9524
1991716644473195_2301769510134572,1,0,0,1,0.9545
1991716644473195_2301774610134062,4,0,0,4,1.83
1991716644473195_2301789493465907,3,1,0,4,1.3212
1991716644473195_2301805996797590,2,0,0,2,0.8808
1991716644473195_2301825813462275,1,2,0,3,0.4404
1991716644473195_2301830693461787,3,1,0,4,1.2231
1991716644473195_2301854293459427,1,1,0,2,0.4404
1991716644473195_2301875460123977,1,0,0,1,0.4404
1991716644473195_2301905490120974,5,0,0,5,2.1831
1991716644473195_2301914536786736,2,1,0,3,0.8619
1991716644473195_2301938303451026,2,1,0,3,0.7615
1991716644473195_2301942613450595,1,0,0,1,0.5719
1991716644473195_2301962363448620,12,1,1,14,5.991
1991716644473195_2302001520111371,17,2,1,20,7.4237
1991716644473195_2302040546774135,9,2,0,11,3.9608
1991716644473195_2302045430106980,13,1,0,14,6.1647
1991716644473195_2302047713440085,2,1,0,3,0.8969
1991716644473195_2302055006772689,3,1,0,4,1.8164
1991716644473195_2302073146770875,21,3,1,25,10.6904
1991716644473195_2302078316770358,1,1,0,2,0.4404
1991716644473195_2302078640103659,2,1,0,3,0.8969
1991716644473195_2302080993436757,1,0,0,1,0.4754
1991716644473195_2302081720103351,1,0,0,1,0.4404
1991716644473195_2302090143435842,6,0,0,6,2.6931
1991716644473195_2302128760098647,1,0,0,1,0.4404
1991716644473195_2302135750097948,1,1,0,2,0.4404
1991716644473195_2302136493431207,1,0,0,1,0.4404
1991716644473195_2302159646762225,1,0,0,1,0.4215
1991716644473195_2302267793418077,2,0,0,2,0.8808
1991716644473195_2302354193409437,3,0,0,3,1.3023
1991716644473195_2302464683398388,2,0,0,2,0.8808
1991716644473195_2302495773395279,4,0,0,4,1.984
1991716644473195_2302525276725662,3,1,0,4,1.0088
1991716644473195_2302533310058192,5,0,0,5,2.3771
1991716644473195_2302551966722993,6,2,0,8,3.3257
1991716644473195_2302553810056142,6,1,1,8,2.7263
1991716644473195_2302589496719240,10,6,1,17,4.4047
1991716644473195_2302597796718410,3,0,0,3,1.4613
1991716644473195_2302628776715312,1,2,0,3,0.8531
1991716644473195_2302672323377624,1,0,0,1,0.4404
1991716644473195_2302709550040568,12,2,0,14,6.9574
1991716644473195_2302754880036035,10,15,0,25,4.28
1991716644473195_2302763216701868,1,0,0,1,0.4404
1991716644473195_2302763596701830,7,0,0,7,3.7436
1991716644473195_2302765153368341,2,1,0,3,0.9866
1991716644473195_2303004393344417,2,0,0,2,0.8808
1991716644473195_2303046353340221,5,0,0,5,2.3146
1991716644473195_2303118839999639,4,0,0,4,2.2918
1991716644473195_2303136526664537,2,1,0,3,0.8808
1991716644473195_2303136616664528,1,0,0,1,0.4404
1991716644473195_2303137476664442,2,0,0,2,0.8619
1991716644473195_2303145026663687,3,0,0,3,1.5057
1991716644473195_2303147469996776,0,1,0,1,0
1991716644473195_2303154756662714,3,1,0,4,1.5888
1991716644473195_2303170603327796,2,0,0,2,0.8619
1991716644473195_2303174746660715,9,1,0,10,4.6237
1991716644473195_2303176656660524,24,1,0,25,12.1
1991716644473195_2303176789993844,1,0,0,1,0.4404
1991716644473195_2303176866660503,4,0,0,4,1.7049
1991716644473195_2303182353326621,7,0,0,7,3.1527
1991716644473195_2303202326657957,2,0,0,2,0.9158
1991716644473195_2303227159988807,1,0,0,1,0.4404
1991716644473195_2303231329988390,2,0,0,2,0.8366
1991716644473195_2303243656653824,7,0,0,7,3.5752
1991716644473195_2303249043319952,5,1,0,6,2.4388
1991716644473195_2303251079986415,1,0,0,1,0.4404
1991716644473195_2303251166653073,2,1,0,3,0.8619
1991716644473195_2303251329986390,5,0,0,5,2.4026
1991716644473195_2303251529986370,6,0,0,6,3.2561
1991716644473195_2303277049983818,5,1,0,6,2.4335
1991716644473195_2303277866650403,2,1,0,3,0.8808
1991716644473195_2303281283316728,2,0,0,2,0.8808
1991716644473195_2303283809983142,3,0,0,3,1.3023
1991716644473195_2303289589982564,2,0,0,2,0.8808
1991716644473195_2303292583315598,11,0,0,11,6.7224
1991716644473195_2303295239981999,4,0,0,4,1.7238
1991716644473195_2303296863315170,5,0,0,5,2.1831
1991716644473195_2303301296648060,4,0,0,4,1.8139
1991716644473195_2303306989980824,2,0,0,2,0.8619
1991716644473195_2303310256647164,1,0,0,1,0.4404
1991716644473195_2303321896646000,4,2,0,6,1.7427
1991716644473195_2303344979977025,8,0,0,8,3.8032
1991716644473195_2303347763310080,5,0,0,5,2.3986
1991716644473195_2303375353307321,3,0,0,3,1.3735
1991716644473195_2303377133307143,1,0,0,1,0.4404
1991716644473195_2303379813306875,2,0,1,3,0.7277
1991716644473195_2303389876639202,1,0,0,1,0.4404
1991716644473195_2303405093304347,2,0,0,2,0.8619
1991716644473195_2303408936637296,2,0,0,2,0.8808
1991716644473195_2303412119970311,1,0,0,1,0.4404
1991716644473195_2303424449969078,2,1,0,3,0.8619
1991716644473195_2303426209968902,4,2,0,6,1.795
1991716644473195_2303435399967983,4,0,0,4,1.7777
1991716644473195_2303447356633454,3,1,0,4,1.3023
1991716644473195_2303459353298921,5,1,0,6,2.237
1991716644473195_2303462663298590,1,0,0,1,0.4404
1991716644473195_2303462996631890,1,1,0,2,0.4404
1991716644473195_2303464389965084,1,0,0,1,0.4404
1991716644473195_2303464876631702,2,0,0,2,0.8808
1991716644473195_2303686559942867,1,1,0,2,0.4215
1991716644473195_2303693359942187,3,0,0,3,1.2834
1991716644473195_2303705969940926,5,0,0,5,2.2181
1991716644473195_2303724839939039,3,0,0,3,1.3023
1991716644473195_2303744966603693,5,0,0,5,2.1453
1991716644473195_2303780429933480,1,2,0,3,0.4404
1991716644473195_2303783159933207,2,0,0,2,0.8619
1991716644473195_2303793289932194,6,2,0,8,2.638
1991716644473195_2303794253265431,20,1,0,21,9.9202
1991716644473195_2303796293265227,4,2,0,6,1.5152
1991716644473195_2303821096596080,3,0,0,3,1.3546
1991716644473195_2303823166595873,1,0,0,1,0.4754
1991716644473195_2303824489929074,3,0,0,3,1.3212
1991716644473195_2303828626595327,1,0,0,1,0.4404
1991716644473195_2303832839928239,2,0,0,2,0.8808
1991716644473195_2303841226594067,22,3,0,25,10.3767
1991716644473195_2303842133260643,2,0,0,2,0.8808
1991716644473195_2303846559926867,2,0,0,2,0.9158
1991716644473195_2303847543260102,3,1,0,4,1.488
1991716644473195_2303857393259117,2,0,0,2,0.8222
1991716644473195_2303871863257670,3,0,0,3,1.3546
1991716644473195_2303872489924274,2,0,0,2,0.9331
1991716644473195_2303875673257289,6,1,0,7,2.755
1991716644473195_2303886023256254,11,3,0,14,5.8188
1991716644473195_2303890319922491,4,0,0,4,1.7427
1991716644473195_2303891596589030,9,0,0,9,4.1446
1991716644473195_2303899899921533,11,5,0,16,4.7158
1991716644473195_2303912326586957,1,0,0,1,0.2732
1991716644473195_2303924583252398,4,0,0,4,1.3606
1991716644473195_2303954283249428,2,0,0,2,1.0398
1991716644473195_2303965173248339,1,0,0,1,0.4404
1991716644473195_2303965946581595,3,0,0,3,1.3023
1991716644473195_2303968033248053,3,0,0,3,1.7795
1991716644473195_2303981816580008,18,4,0,22,10.4759
1991716644473195_2303983169913206,9,2,0,11,4.5199
1991716644473195_2303988596579330,2,0,0,2,0.9331
1991716644473195_2303993696578820,2,0,0,2,0.8619
1991716644473195_2304022626575927,4,0,0,4,1.9461
1991716644473195_2304048369906686,1,0,0,1,0.4404
1991716644473195_2304054376572752,4,0,0,4,1.7761
1991716644473195_2304066413238215,6,0,0,6,2.638
1991716644473195_2304076476570542,5,1,0,6,2.3329
1991716644473195_2304076773237179,2,0,0,2,0.5176
1991716644473195_2304082239903299,4,0,0,4,1.3795
1991716644473195_2304082736569916,15,1,0,16,7.4395
1991716644473195_2304088079902715,3,0,0,3,0.958
1991716644473195_2304089256569264,4,1,0,5,1.795
1991716644473195_2304120246566165,3,0,0,3,1.3212
1991716644473195_2304129526565237,5,1,0,6,2.5122
1991716644473195_2304133689898154,5,0,0,5,2.1642
1991716644473195_2304135746564615,5,1,0,6,2.2165
1991716644473195_2304235676554622,3,2,0,5,1.2834
1991716644473195_2304447056533484,9,0,0,9,3.936
1991716644473195_2304487616529428,5,0,0,5,2.1831
1991716644473195_2304494066528783,8,2,0,10,3.8623
1991716644473195_2304495413195315,0,1,0,1,0
1991716644473195_2304514313193425,0,4,1,5,-0.4588
1991716644473195_2304519729859550,2,0,0,2,0.8808
1991716644473195_2304521246526065,1,2,1,4,0.1444
1991716644473195_2304523743192482,6,0,0,6,2.7361
1991716644473195_2304526036525586,10,1,0,11,4.5964
1991716644473195_2304555709855952,8,0,0,8,4.207
1991716644473195_2304597986518391,2,0,0,2,0.8808
1991716644473195_2304599543184902,5,1,0,6,2.3904
1991716644473195_2304605609850962,5,2,0,7,2.3865
1991716644473195_2304607926517397,2,0,0,2,0.8808
1991716644473195_2304611823183674,1,0,0,1,0.4404
1991716644473195_2304611923183664,6,0,0,6,3.0528
1991716644473195_2304612509850272,9,0,0,9,4.8777
1991716644473195_2304616169849906,4,0,0,4,1.9272
1991716644473195_2304619026516287,1,0,0,1,0.4404
1991716644473195_2304619343182922,2,0,0,2,0.8808
1991716644473195_2304622956515894,3,0,0,3,1.3212
1991716644473195_2304634369848086,4,0,0,4,1.7427
1991716644473195_2304637786514411,1,0,0,1,0.4404
1991716644473195_2304643569847166,4,0,0,4,1.9017
1991716644473195_2304648143180042,3,0,0,3,1.8492
1991716644473195_2304648489846674,1,0,0,1,0.4404
1991716644473195_2304655739845949,9,1,0,10,3.4177
1991716644473195_2304662729845250,0,1,0,1,0
1991716644473195_2304663619845161,1,0,0,1,0.4404
1991716644473195_2304667556511434,5,0,0,5,2.1831
1991716644473195_2304668053178051,2,0,0,2,0.8808
1991716644473195_2304677999843723,2,0,0,2,0.8619
1991716644473195_2304683233176533,4,2,0,6,1.8139
1991716644473195_2304689569842566,1,0,0,1,0.4404
1991716644473195_2304715563173300,5,3,0,8,1.9594
1991716644473195_2304730613171795,2,0,0,2,0.9142
1991716644473195_2304731029838420,8,2,0,10,3.5204
1991716644473195_2304738796504310,2,1,0,3,0.8808
1991716644473195_2304743293170527,4,2,0,6,1.7238
1991716644473195_2304752039836319,4,0,0,4,1.7427
1991716644473195_2304753413169515,6,4,0,10,2.8241
1991716644473195_2304755816502608,4,0,0,4,1.7238
1991716644473195_2304758729835650,3,0,0,3,1.3023
1991716644473195_2304758743168982,5,0,0,5,2.5612
1991716644473195_2304760956502094,6,1,0,7,2.8865
1991716644473195_2304768543168002,9,0,0,9,3.6338
1991716644473195_2304768679834655,2,1,0,3,0.8808
1991716644473195_2304770599834463,14,2,0,16,6.4185
1991716644473195_2304773739834149,4,0,0,4,1.7601
1991716644473195_2304774623167394,1,0,0,1,0.4404
1991716644473195_2304777009833822,2,0,0,2,0.5176
1991716644473195_2304780686500121,5,1,0,6,2.8924
1991716644473195_2304810533163803,5,0,0,5,1.801
1991716644473195_2304841896494000,0,1,0,1,0
1991716644473195_2304856143159242,3,1,0,4,1.3735
1991716644473195_2304887256489464,8,0,0,8,3.5755
1991716644473195_2304902619821261,5,1,0,6,2.1642
1991716644473195_2304908116487378,18,7,0,25,8.9752
1991716644473195_2304910623153794,9,2,0,11,4.7827
1991716644473195_2304912873153569,3,0,0,3,1.3212
1991716644473195_2304912923153564,10,1,0,11,4.8159
1991716644473195_2304919419819581,2,0,0,2,0.8808
1991716644473195_2304922309819292,6,1,0,7,2.5857
1991716644473195_2304930043151852,9,1,0,10,3.9247
1991716644473195_2304930266485163,6,2,0,8,2.6046
1991716644473195_2304936929817830,2,0,0,2,0.8619
1991716644473195_2304937039817819,21,4,0,25,10.2091
1991716644473195_2304943439817179,3,0,0,3,1.3212
1991716644473195_2304944063150450,4,0,0,4,1.7427
1991716644473195_2304944919817031,15,0,0,15,7.3017
1991716644473195_2304945503150306,2,0,0,2,0.8619
1991716644473195_2304959216482268,1,0,0,1,0.4404
1991716644473195_2304960129815510,1,2,0,3,0.4404
1991716644473195_2304963693148487,2,0,0,2,0.8619
1991716644473195_2304994399812083,3,0,0,3,1.3023
1991716644473195_2305219009789622,1,0,0,1,0.4404
1991716644473195_2305224039789119,5,0,0,5,2.3676
1991716644473195_2305267726451417,5,0,0,5,2.2354
1991716644473195_2305273133117543,2,0,0,2,0.8808
1991716644473195_2305273429784180,5,0,0,5,2.4388
1991716644473195_2305302269781296,8,3,0,11,3.598
1991716644473195_2305327563112100,2,0,0,2,0.8808
1991716644473195_2305347146443475,2,0,0,2,1.0653
1991716644473195_2305352309776292,4,1,0,5,1.7616
1991716644473195_2305354589776064,1,0,0,1,0.4404
1991716644473195_2305358646442325,4,0,0,4,1.7427
1991716644473195_2305364689775054,1,0,0,1,0.4404
1991716644473195_2305370239774499,1,1,0,2,0.4404
1991716644473195_2305373029774220,18,7,0,25,9.7267
1991716644473195_2305376016440588,2,0,0,2,0.8808
1991716644473195_2305376369773886,3,0,0,3,1.795
1991716644473195_2305377156440474,3,0,0,3,1.2834
1991716644473195_2305377989773724,4,1,0,5,1.7347
1991716644473195_2305384333106423,6,0,0,6,2.7198
1991716644473195_2305390413105815,2,0,0,2,1.2778
1991716644473195_2305400133104843,4,0,0,4,1.7238
1991716644473195_2305433793101477,3,0,0,3,1.3212
1991716644473195_2305434666434723,23,2,0,25,11.4526
1991716644473195_2305436599767863,3,1,0,4,1.3212
1991716644473195_2305451429766380,5,1,0,6,2.237
1991716644473195_2305468219764701,1,1,0,2,0.4404
1991716644473195_2305476826430507,7,3,0,10,3.6933
1991716644473195_2305477719763751,3,0,0,3,1.3212
1991716644473195_2305481356430054,11,1,0,12,4.9366
1991716644473195_2305486803096176,3,1,0,4,1.3212
1991716644473195_2305491593095697,5,0,0,5,2.1264
1991716644473195_2305493373095519,1,0,0,1,0.4404
1991716644473195_2305494386428751,3,0,0,3,1.3546
1991716644473195_2305498516428338,3,1,0,4,1.2834
1991716644473195_2305499249761598,5,0,0,5,2.2354
1991716644473195_2305525529758970,1,1,0,2,0.4215
1991716644473195_2305527946425395,1,0,0,1,0.4215
1991716644473195_2305528233092033,21,4,0,25,11.8566
1991716644473195_2305530539758469,3,0,0,3,1.7964
1991716644473195_2305533749758148,4,0,0,4,1.6446
1991716644473195_2305538793090977,1,2,0,3,0.4404
1991716644473195_2305542956423894,2,1,0,3,1.1407
1991716644473195_2305579443086912,3,1,0,4,1.3212
1991716644473195_2305588256419364,2,0,0,2,0.8808
1991716644473195_2305591209752402,3,4,0,7,1.7033
1991716644473195_2305602179751305,2,0,0,2,0.8808
1991716644473195_2305603846417805,3,1,0,4,0.9835
1991716644473195_2305607219750801,1,0,0,1,0.4754
1991716644473195_2305608009750722,6,2,0,8,4.0592
1991716644473195_2305612529750270,5,4,0,9,2.1831
1991716644473195_2305630826415107,2,2,0,4,0.8808
1991716644473195_2305643579747165,4,2,0,6,2.5765
1991716644473195_2305656969745826,18,2,0,20,10.4475
1991716644473195_2305669983077858,1,1,0,2,0.4404
1991716644473195_2305670323077824,5,1,0,6,2.2354
1991716644473195_2305672429744280,2,0,0,2,0.8808
1991716644473195_2305684156409774,4,5,0,9,2.2317
1991716644473195_2305692559742267,2,0,0,2,1.3967
1991716644473195_2305696713075185,2,0,0,2,0.8808
1991716644473195_2305709969740526,2,0,0,2,0.8808
1991716644473195_2305728669738656,7,1,0,8,3.8175
1991716644473195_2305908083054048,7,1,0,8,3.5738
1991716644473195_2305909579720565,1,2,0,3,0.4404
1991716644473195_2305924673052389,1,0,0,1,0.4404
1991716644473195_2305977933047063,1,1,0,2,0.4404
1991716644473195_2306040156374174,4,1,0,5,1.9083
1991716644473195_2306043806373809,4,2,0,6,2.598
1991716644473195_2306048213040035,1,0,0,1,0.9333
1991716644473195_2306052969706226,1,0,0,1,0.4404
1991716644473195_2306055409705982,3,0,0,3,1.3562
1991716644473195_2306064776371712,4,0,0,4,1.7238
1991716644473195_2306068889704634,1,1,0,2,0.4404
1991716644473195_2306072913037565,2,0,0,2,0.843
1991716644473195_2306073423037514,1,0,0,1,0.4215
1991716644473195_2306074203037436,5,1,0,6,2.4215
1991716644473195_2306078683036988,3,0,0,3,1.3562
1991716644473195_2306082616369928,5,2,0,7,2.2877
1991716644473195_2306084903036366,0,1,0,1,0
1991716644473195_2306086869702836,1,1,0,2,0.4404
1991716644473195_2306094366368753,1,0,0,1,0.4404
1991716644473195_2306094609702062,2,0,0,2,0.9331
1991716644473195_2306106206367569,3,1,0,4,1.3212
1991716644473195_2306107416367448,1,1,0,2,0.4404
1991716644473195_2306118856366304,2,0,0,2,0.8808
1991716644473195_2306126093032247,2,0,0,2,0.8619
1991716644473195_2306147713030085,2,1,0,3,0.8619
1991716644473195_2306149489696574,1,0,0,1,0.4404
1991716644473195_2306153743029482,5,0,0,5,2.1831
1991716644473195_2306155136362676,2,0,0,2,1.0653
1991716644473195_2306155263029330,2,0,0,2,0.9331
1991716644473195_2306157053029151,2,1,0,3,1.3949
1991716644473195_2306157496362440,1,0,0,1,0.4404
1991716644473195_2306158619695661,22,3,0,25,11.4774
1991716644473195_2306160386362151,2,0,0,2,0.8808
1991716644473195_2306160646362125,3,0,0,3,1.2834
1991716644473195_2306161246362065,1,0,0,1,0.4404
1991716644473195_2306173163027540,14,0,0,14,6.6063
1991716644473195_2306196359691887,20,5,0,25,11.6225
1991716644473195_2306207399690783,2,0,0,2,0.8808
1991716644473195_2306213513023505,1,0,0,1,0.4404
1991716644473195_2306213683023488,4,1,0,5,1.795
1991716644473195_2306215383023318,4,0,0,4,1.7238
1991716644473195_2306217463023110,2,2,0,4,0.8808
1991716644473195_2306220216356168,12,2,0,14,6.1032
1991716644473195_2306220483022808,3,2,0,5,1.3023
1991716644473195_2306222156355974,5,0,0,5,2.6772
1991716644473195_2306222559689267,3,0,0,3,0.958
1991716644473195_2306223016355888,2,1,0,3,0.7136
1991716644473195_2306226666355523,4,3,0,7,2.3166
1991716644473195_2306226786355511,4,0,0,4,1.7427
1991716644473195_2306227149688808,10,1,0,11,4.9131
1991716644473195_2306231519688371,2,1,0,3,0.8619
1991716644473195_2306233213021535,2,0,0,2,0.8808
1991716644473195_2306239846354205,1,0,0,1,0.4404
1991716644473195_2306243816353808,13,1,0,14,6.4411
1991716644473195_2306244739687049,1,0,0,1,0.4404
1991716644473195_2306258509685672,1,0,0,1,0.4404
1991716644473195_2306267003018156,6,0,0,6,2.6046
1991716644473195_2306269169684606,1,0,0,1,0.4404
1991716644473195_2306273879684135,2,0,0,2,0.8808
1991716644473195_2306278456350344,4,1,0,5,2.1299
1991716644473195_2306279499683573,4,0,0,4,1.7238
1991716644473195_2306279679683555,5,1,0,6,2.3073
1991716644473195_2306279713016885,22,3,0,25,10.5945
1991716644473195_2306282193016637,3,0,0,3,1.3212
1991716644473195_2306294683015388,10,3,0,13,5.4688
1991716644473195_2306295276348662,2,2,0,4,0.8808
1991716644473195_2306298923014964,1,1,0,2,0.4404
1991716644473195_2306320403012816,3,0,0,3,1.3212
1991716644473195_2306329896345200,3,1,0,4,1.3023
1991716644473195_2306337946344395,2,2,0,4,0.9331
1991716644473195_2306341666344023,6,2,0,8,3.035
1991716644473195_2306348699676653,3,0,0,3,1.242
1991716644473195_2306350566343133,4,0,0,4,2.1088
1991716644473195_2306353876342802,3,1,0,4,1.5057
1991716644473195_2306357019675821,5,0,0,5,1.8722
1991716644473195_2306366103008246,6,1,0,7,2.4637
1991716644473195_2306371763007680,6,1,0,7,2.6046
1991716644473195_2306373669674156,3,1,0,4,1.3212
1991716644473195_2306385003006356,2,0,0,2,1.0653
1991716644473195_2306393396338850,3,1,0,4,1.3212
1991716644473195_2306393463005510,1,0,0,1,0.4404
1991716644473195_2306395086338681,2,0,0,2,0.8808
1991716644473195_2306396123005244,1,0,0,1,0.4404
1991716644473195_2306397789671744,8,1,0,9,3.2993
1991716644473195_2306397873005069,1,0,0,1,0.4404
1991716644473195_2306408083004048,1,0,0,1,0.3818
1991716644473195_2306603922984464,1,0,0,1,0.4404
1991716644473195_2306681236310066,11,1,0,12,5.2335
1991716644473195_2306681862976670,2,0,0,2,1.3949
1991716644473195_2306682049643318,2,0,0,2,0.8808
1991716644473195_2306688229642700,7,2,0,9,2.7196
1991716644473195_2306690459642477,5,2,0,7,2.1992
1991716644473195_2306697479641775,17,0,0,17,7.3502
1991716644473195_2306697679641755,2,0,0,2,0.9331
1991716644473195_2306698069641716,2,0,0,2,0.8808
1991716644473195_2306708062974050,1,0,0,1,0.4927
1991716644473195_2306708522974004,4,2,1,7,1.6655
1991716644473195_2306709102973946,1,0,0,1,0.4404
1991716644473195_2306724209639102,4,0,0,4,2.042
1991716644473195_2306725502972306,1,0,0,1,0.4404
1991716644473195_2306734752971381,3,1,0,4,1.3212
1991716644473195_2306761069635416,3,0,0,3,1.3212
1991716644473195_2306761416302048,10,2,0,12,5.9977
1991716644473195_2306767299634793,3,0,0,3,1.3735
1991716644473195_2306776526300537,1,0,0,1,0.4927
1991716644473195_2306789642965892,20,3,0,23,9.1908
1991716644473195_2306808286297361,7,0,0,7,3.2374
1991716644473195_2306811956296994,3,0,0,3,1.4613
1991716644473195_2306829539628569,10,2,0,12,3.9798
1991716644473195_2306860822958774,15,2,1,18,6.1522
1991716644473195_2306867992958057,9,1,1,11,3.6503
1991716644473195_2306875772957279,17,7,1,25,9.1093
1991716644473195_2306885366289653,1,1,0,2,0.4404
1991716644473195_2306889306289259,3,0,0,3,0.888
1991716644473195_2306889632955893,3,0,0,3,1.3212
1991716644473195_2306894522955404,2,0,0,2,1.0889
1991716644473195_2306908999620623,2,2,0,4,0.843
1991716644473195_2306922806285909,7,5,0,12,3.5214
1991716644473195_2306935476284642,2,0,0,2,0.8808
1991716644473195_2306958636282326,7,3,0,10,3.4272
1991716644473195_2306966746281515,5,5,0,10,2.752
1991716644473195_2307007266277463,0,1,0,1,0
1991716644473195_2307017472943109,2,0,0,2,0.8808
1991716644473195_2307028589608664,3,0,0,3,1.2834
1991716644473195_2307052456272944,1,0,0,1,0.4215
1991716644473195_2307072722937584,4,0,0,4,1.3984
1991716644473195_2307114206266769,1,0,0,1,0.4404
1991716644473195_2307127019598821,8,10,4,22,2.8498
1991716644473195_2307146836263506,2,0,0,2,0.8619
1991716644473195_2307147382930118,1,0,0,1,0.4404
1991716644473195_2307155306262659,1,2,0,3,0.4404
1991716644473195_2307192819592241,3,0,0,3,1.3023
1991716644473195_2307434516234738,2,0,0,2,0.8619
1991716644473195_2307464906231699,6,2,0,8,2.6396
1991716644473195_2307478789563644,9,4,0,13,5.628
1991716644473195_2307540806224109,1,0,0,1,0.4404
1991716644473195_2307548876223302,1,0,0,1,0.4404
1991716644473195_2307642036213986,5,1,0,6,2.1642
1991716644473195_2307685526209637,3,0,0,3,1.3023
1991716644473195_2307690262875830,5,0,0,5,2.4133
1991716644473195_2307697502875106,2,0,0,2,0.6947
1991716644473195_2307718742872982,3,0,0,3,1.3023
1991716644473195_2307895586188631,2,0,0,2,0.8808
1991716644473195_2307896932855163,4,0,0,4,1.7616
1991716644473195_2307897519521771,2,0,0,2,0.8808
1991716644473195_2307898049521718,2,0,0,2,0.8808
1991716644473195_2307942792850577,17,7,0,24,9.2025
1991716644473195_2308153466162843,1,0,0,1,0.4404
1991716644473195_2308162532828603,3,0,0,3,1.3212
1991716644473195_2308172486160941,2,1,1,4,0.5659
1991716644473195_2308174639494059,3,1,0,4,1.3735
1991716644473195_2308199082824948,1,0,0,1,0.4404
1991716644473195_2308209709490552,11,2,0,13,4.9332
1991716644473195_2308211732823683,11,1,0,12,5.1364
1991716644473195_2308213029490220,5,0,0,5,2.3307
1991716644473195_2308227189488804,2,0,0,2,0.8619
1991716644473195_2308245542820302,2,0,0,2,0.8808
1991716644473195_2308278852816971,1,0,0,1,0.4404
1991716644473195_2308279222816934,3,0,0,3,1.3546
1991716644473195_2308288386149351,1,0,0,1,0.4404
1991716644473195_2308311972813659,3,0,0,3,1.3023
1991716644473195_2308315396146650,2,0,0,2,0.8808
1991716644473195_2308328962811960,6,0,0,6,2.5202
1991716644473195_2308335809477942,5,0,0,5,2.5464
1991716644473195_2308340639477459,4,0,1,5,1.9361
1991716644473195_2308341902810666,3,0,0,3,1.154
1991716644473195_2308343842810472,1,0,0,1,0.4404
1991716644473195_2308372716140918,1,0,0,1,0.4404
1991716644473195_2308380359473487,1,0,0,1,0.4215
1991716644473195_2308381162806740,5,0,0,5,2.1453
1991716644473195_2308393536138836,3,0,0,3,1.3212
1991716644473195_2308393976138792,3,0,0,3,1.3023
1991716644473195_2308399302804926,4,0,0,4,1.7427
1991716644473195_2308419376136252,9,0,0,9,5.4367
1991716644473195_2308422576135932,6,2,0,8,2.5857
1991716644473195_2308424359469087,19,1,0,20,9.2184
1991716644473195_2308424789469044,1,0,0,1,0.4404
1991716644473195_2308426592802197,1,0,0,1,0.4404
1991716644473195_2308429016135288,5,0,0,5,2.1642
1991716644473195_2308460949465428,2,0,0,2,1.0123
1991716644473195_2308463136131876,5,0,0,5,2.202
1991716644473195_2308463272798529,1,0,0,1,0.4404
1991716644473195_2308463312798525,6,3,0,9,2.8269
1991716644473195_2308464269465096,1,0,0,1,0.4404
1991716644473195_2308476102797246,8,1,0,9,3.8922
1991716644473195_2308482299463293,1,0,0,1,0.4404
1991716644473195_2308483546129835,1,0,0,1,0.4404
1991716644473195_2308484232796433,2,0,0,2,0.5176
1991716644473195_2308485506129639,1,0,0,1,0.4404
1991716644473195_2308488029462720,1,0,0,1,0.4404
1991716644473195_2308488646129325,3,0,0,3,1.3023
1991716644473195_2308490289462494,3,0,0,3,1.3023
1991716644473195_2308491312795725,2,0,0,2,0.8808
1991716644473195_2308496992795157,23,2,0,25,12.1172
1991716644473195_2308498346128355,1,0,0,1,0.4404
1991716644473195_2308501556128034,2,0,0,2,0.7136
1991716644473195_2308503789461144,1,0,0,1,0.4404
1991716644473195_2308510569460466,2,0,0,2,1.0653
1991716644473195_2308516399459883,1,0,0,1,0.4404
1991716644473195_2308529399458583,1,0,0,1,0.4404
1991716644473195_2308547232790133,3,0,0,3,1.3212
1991716644473195_2308547296123460,1,0,0,1,0.4404
1991716644473195_2308598689451654,1,0,0,1,0.4404
1991716644473195_2308604896117700,5,0,0,5,2.1831
1991716644473195_2308686222776234,6,1,0,7,2.6046
1991716644473195_2308838486094341,5,0,0,5,2.2889
1991716644473195_2308881722756684,6,0,0,6,2.747
1991716644473195_2308889422755914,9,0,0,9,4.311
1991716644473195_2308891329422390,4,0,0,4,1.7777
1991716644473195_2308915142753342,1,0,0,1,0.4404
1991716644473195_2308915272753329,4,0,0,4,2.2356
1991716644473195_2308926266085563,2,0,0,2,1.0398
1991716644473195_2308957142749142,22,3,0,25,12.5414
1991716644473195_2308971292747727,10,1,0,11,4.4616
1991716644473195_2308978859413637,18,1,0,19,8.5729
1991716644473195_2308992066078983,1,0,0,1,0.4404
1991716644473195_2308996286078561,1,0,0,1,0.4404
1991716644473195_2309007879410735,9,0,0,9,4.2875
1991716644473195_2309009452743911,1,0,0,1,0.4404
1991716644473195_2309014526076737,2,0,0,2,0.5176
1991716644473195_2309017579409765,9,0,0,9,4.186
1991716644473195_2309019066076283,2,1,0,3,0.8619
1991716644473195_2309023876075802,6,0,0,6,2.6559
1991716644473195_2309031522741704,0,2,0,2,0
1991716644473195_2309034559408067,1,0,0,1,0.4404
1991716644473195_2309041806074009,4,0,0,4,1.7966
1991716644473195_2309048166073373,11,2,0,13,5.3099
1991716644473195_2309056009405922,3,0,0,3,1.2834
1991716644473195_2309058916072298,4,0,0,4,1.7238
1991716644473195_2309066376071552,12,1,0,13,6.4976
1991716644473195_2309075559403967,1,0,1,2,-0.1491
1991716644473195_2309087546069435,4,0,0,4,1.795
1991716644473195_2309090132735843,3,0,0,3,1.3212
1991716644473195_2309104476067742,3,2,0,5,1.3546
1991716644473195_2309114246066765,9,0,0,9,4.2333
1991716644473195_2309123846065805,9,1,0,10,4.1257
1991716644473195_2309135436064646,7,0,0,7,3.0197
1991716644473195_2309140602730796,7,0,0,7,3.6845
1991716644473195_2309149756063214,1,0,0,1,0.4404
1991716644473195_2309167762728080,4,3,0,7,1.8384
1991716644473195_2309183139393209,1,0,0,1,0.3818
1991716644473195_2309183946059795,1,0,0,1,0.4404
1991716644473195_2309190482725808,3,0,0,3,1.3023
1991716644473195_2309191436059046,2,0,0,2,0.8808
1991716644473195_2309196992725157,6,0,0,6,2.7702
1991716644473195_2309202279391295,1,0,0,1,0.4404
1991716644473195_2309204242724432,4,0,0,4,1.7427
1991716644473195_2309205746057615,5,0,0,5,2.6836
1991716644473195_2309208709390652,11,0,0,11,4.8255
1991716644473195_2309221919389331,2,0,0,2,0.8808
1991716644473195_2309225819388941,4,0,0,4,2.2926
1991716644473195_2309240522720804,1,0,0,1,0.4404
1991716644473195_2309249319386591,1,0,0,1,0.4404
1991716644473195_2309259722718884,4,0,0,4,1.7238
1991716644473195_2309288362716020,2,0,0,2,0.8619
1991716644473195_2309305326047657,2,1,0,3,1.0398
1991716644473195_2309310172713839,2,0,0,2,0.5176
1991716644473195_2309326589378864,15,2,1,18,6.4611
1991716644473195_2309332059378317,6,0,0,6,2.6235
1991716644473195_2309335826044607,1,0,0,1,0.4404
1991716644473195_2309351679376355,2,0,0,2,0.843
1991716644473195_2309358226042367,2,0,0,2,0.8969
1991716644473195_2309365822708274,3,0,0,3,1.3023
1991716644473195_2309394579372065,1,1,0,2,0.4404
1991716644473195_2309398639371659,1,0,0,1,0.4404
1991716644473195_2309409496037240,4,1,0,5,1.3795
1991716644473195_2309636302681226,6,0,1,7,2.2027
1991716644473195_2309640469347476,3,1,0,4,2.008
1991716644473195_2309685266009663,1,1,0,2,0.4215
1991716644473195_2309740139337509,2,1,0,3,1.2245
1991716644473195_2309767282668128,1,0,0,1,0.4404
1991716644473195_2309770992667757,2,0,0,2,0.8619
1991716644473195_2309770999334423,0,2,0,2,0
1991716644473195_2309771932667663,12,2,0,14,5.3327
1991716644473195_2309772179334305,2,0,0,2,0.8808
1991716644473195_2309772462667610,20,3,0,23,10.4028
1991716644473195_2309772689334254,2,0,0,2,0.8808
1991716644473195_2309773376000852,3,0,0,3,1.3023
1991716644473195_2309774592667397,2,3,0,5,0.843
1991716644473195_2309778319333691,1,4,0,5,0.4404
1991716644473195_2309783029333220,3,0,0,3,1.3373
1991716644473195_2309790552665801,6,1,0,7,2.6235
1991716644473195_2309793355998854,1,0,0,1,0.4404
1991716644473195_2309797539331769,2,0,0,2,0.9158
1991716644473195_2309812645996925,8,0,0,8,4.0134
1991716644473195_2309813602663496,4,5,1,10,1.5081
1991716644473195_2309815722663284,3,0,0,3,1.3212
1991716644473195_2309817892663067,6,0,0,6,2.6235
1991716644473195_2309827115995478,6,0,0,6,2.7361
1991716644473195_2309829559328567,1,0,0,1,0.4404
1991716644473195_2309829712661885,5,1,0,6,2.1642
1991716644473195_2309829759328547,1,0,0,1,0.4404
1991716644473195_2309830055995184,1,0,0,1,0.4404
1991716644473195_2309830595995130,2,0,0,2,0.8808
1991716644473195_2309830692661787,1,0,0,1,0.7615
1991716644473195_2309841192660737,1,0,0,1,0.4404
1991716644473195_2309847005993489,2,1,0,3,0.8808
1991716644473195_2309856255992564,2,0,0,2,0.8808
1991716644473195_2309861545992035,1,0,0,1,0.4404
1991716644473195_2309863565991833,2,0,0,2,0.8808
1991716644473195_2309865245991665,5,0,0,5,2.5983
1991716644473195_2309869615991228,1,0,0,1,0.4404
1991716644473195_2309878735990316,8,4,0,12,3.8218
1991716644473195_2309886209322902,3,0,0,3,1.3212
1991716644473195_2309895272655329,3,0,0,3,1.4802
1991716644473195_2309900725988117,18,2,0,20,8.7667
1991716644473195_2309901569321366,7,0,0,7,3.0616
1991716644473195_2309902939321229,5,0,0,5,2.4516
1991716644473195_2309909615987228,18,0,0,18,8.9265
1991716644473195_2309910649320458,5,0,0,5,2.8327
1991716644473195_2309912849320238,4,1,0,5,1.8553
1991716644473195_2309919519319571,3,0,0,3,1.3212
1991716644473195_2309926935985496,7,0,0,7,3.1162
1991716644473195_2309932372651619,3,0,0,3,1.3023
1991716644473195_2309933892651467,2,0,0,2,1.4148
1991716644473195_2309939569317566,16,8,1,25,6.4378
1991716644473195_2309939609317562,6,1,0,7,2.5668
1991716644473195_2309940975984092,4,0,0,4,1.7427
1991716644473195_2309941515984038,13,0,0,13,6.2038
1991716644473195_2309942165983973,4,0,0,4,1.7427
1991716644473195_2309967502648106,4,0,0,4,1.9017
1991716644473195_2309975595980630,5,0,0,5,3.0597
1991716644473195_2309983645979825,3,0,0,3,1.3373
1991716644473195_2309986109312912,1,1,0,2,0.4404
1991716644473195_2309989755979214,11,0,0,11,5.5229
1991716644473195_2310014135976776,4,0,0,4,1.7238
1991716644473195_2310016685976521,4,0,0,4,1.7427
1991716644473195_2310040142640842,5,0,0,5,2.7157
1991716644473195_2310055495972640,5,0,0,5,2.3943
1991716644473195_2310058439305679,19,3,0,22,10.424
1991716644473195_2310067352638121,1,0,0,1,0.4404
1991716644473195_2310083162636540,2,0,0,2,1.4101
1991716644473195_2310099275968262,3,0,0,3,1.3023
1991716644473195_2310110339300489,3,0,0,3,1.3023
1991716644473195_2310195732625283,1,0,0,1,0.4215
1991716644473195_2310269605951229,6,0,0,6,2.6046
1991716644473195_2310270825951107,8,0,0,8,3.5015
1991716644473195_2310297129281810,1,0,0,1,0.4404
1991716644473195_2310325452612311,6,1,0,7,2.895
1991716644473195_2310326282612228,2,0,0,2,0.8808
1991716644473195_2310348979276625,3,0,0,3,1.3212
1991716644473195_2310362309275292,5,0,0,5,2.1039
1991716644473195_2310362759275247,6,1,0,7,2.5777
1991716644473195_2310375492607307,11,1,1,13,5.1149
1991716644473195_2310387725939417,13,2,0,15,6.9764
1991716644473195_2310388842605972,7,1,0,8,3.939
1991716644473195_2310402209271302,4,1,0,5,1.7616
1991716644473195_2310406015937588,2,0,0,2,0.8808
1991716644473195_2310421945935995,1,0,0,1,0.4404
1991716644473195_2310457319265791,9,3,0,12,4.7847
1991716644473195_2310458172599039,2,2,0,4,0.8808
1991716644473195_2310461355932054,5,1,0,6,2.479
1991716644473195_2310461575932032,7,0,0,7,3.1765
1991716644473195_2310463712598485,12,4,1,17,5.3843
1991716644473195_2310471545931035,3,0,0,3,1.3023
1991716644473195_2310495122595344,3,0,0,3,1.3914
1991716644473195_2310497429261780,1,1,0,2,0.4404
1991716644473195_2310503712594485,2,0,0,2,1.2433
1991716644473195_2310511512593705,4,0,0,4,1.9351
1991716644473195_2310519062592950,4,0,0,4,1.795
1991716644473195_2310529412591915,1,0,0,1,0.4404
1991716644473195_2310531249258398,4,2,0,6,2.2516
1991716644473195_2310534889258034,1,0,0,1,0.4404
1991716644473195_2310535882591268,3,0,0,3,1.3546
1991716644473195_2310537555924434,10,3,0,13,4.7642
1991716644473195_2310541889257334,1,0,0,1,0.4927
1991716644473195_2310543192590537,1,0,0,1,0.4404
1991716644473195_2310543992590457,9,0,0,9,4.067
1991716644473195_2310544249257098,1,0,0,1,0.6361
1991716644473195_2310555062589350,1,0,0,1,0.4404
1991716644473195_2310563862588470,13,0,0,13,5.5391
1991716644473195_2310575459253977,3,2,0,5,1.3735
1991716644473195_2310584559253067,4,0,0,4,1.795
1991716644473195_2310585692586287,5,2,0,7,2.2704
1991716644473195_2310586629252860,1,0,0,1,0.4404
1991716644473195_2310597362585120,3,0,0,3,1.4149
1991716644473195_2310602125917977,6,0,0,6,3.2227
1991716644473195_2310609885917201,4,0,0,4,1.8473
1991716644473195_2310610585917131,2,0,0,2,0.5526
1991716644473195_2310632675914922,2,0,0,2,0.8808
1991716644473195_2310657842579072,9,2,0,11,6.0673
1991716644473195_2310668505911339,6,0,0,6,2.5609
1991716644473195_2310676095910580,1,0,0,1,0.4927
1991716644473195_2310676425910547,9,0,0,9,5.1093
1991716644473195_2310686002576256,3,0,0,3,1.3212
1991716644473195_2310688379242685,9,1,0,10,4.6101
1991716644473195_2310689825909207,1,0,0,1,0.4927
1991716644473195_2310707462574110,4,1,0,5,1.7427
1991716644473195_2310727942572062,18,6,1,25,7.8114
1991716644473195_2310760719235451,5,0,0,5,2.1831
1991716644473195_2310775579233965,5,0,0,5,2.2354
1991716644473195_2310787429232780,3,0,0,3,1.3735
1991716644473195_2310791175899072,16,9,0,25,8.2058
1991716644473195_2310800902564766,6,0,0,6,2.5857
1991716644473195_2310813209230202,4,0,0,4,1.6635
1991716644473195_2310843062560550,2,1,0,3,0.8808
1991716644473195_2310944362550420,1,0,0,1,0.4404
1991716644473195_2310951652549691,2,0,0,2,0.8808
1991716644473195_2310951729216350,7,0,0,7,2.9658
1991716644473195_2311018205876369,4,0,0,4,1.8742
1991716644473195_2311023872542469,4,0,0,4,1.7616
1991716644473195_2311024782542378,1,0,0,1,0.4404
1991716644473195_2311029509208572,3,0,0,3,1.3212
1991716644473195_2311031609208362,18,7,0,25,10.1191
1991716644473195_2311039559207567,6,1,0,7,2.808
1991716644473195_2311045369206986,2,0,0,2,0.9783
1991716644473195_2311063509205172,14,1,0,15,7.1235
1991716644473195_2311075502537306,1,0,0,1,0.4404
1991716644473195_2311080089203514,11,0,2,13,4.736
1991716644473195_2311089319202591,2,0,0,2,0.8808
1991716644473195_2311101695868020,3,0,0,3,1.3212
1991716644473195_2311110862533770,7,1,0,8,3.2359
1991716644473195_2311139645864225,6,0,0,6,2.6046
1991716644473195_2311162049195318,2,0,0,2,0.9331
1991716644473195_2311175745860615,11,2,0,13,5.1827
1991716644473195_2311216249189898,2,0,0,2,0.9331
1991716644473195_2311228392522017,2,0,0,2,0.8619
1991716644473195_2311236089187914,21,3,1,25,10.7526
1991716644473195_2311237992521057,2,0,0,2,0.8619
1991716644473195_2311241209187402,10,1,0,11,4.9796
1991716644473195_2311241279187395,6,2,0,8,2.6758
1991716644473195_2311245109187012,6,1,0,7,3.1353
1991716644473195_2311247259186797,19,5,0,24,9.7896
1991716644473195_2311253792519477,15,1,1,17,7.1104
1991716644473195_2311255929185930,9,0,0,9,3.9321
1991716644473195_2311261072518749,2,0,0,2,0.9331
1991716644473195_2311263905851799,2,0,0,2,0.9331
1991716644473195_2311266229184900,6,0,0,6,2.9933
1991716644473195_2311280229183500,3,0,0,3,1.3735
1991716644473195_2311281155850074,2,0,0,2,0.9331
1991716644473195_2311285325849657,2,0,0,2,0.9934
1991716644473195_2311287989182724,22,3,0,25,10.855
1991716644473195_2311289392515917,3,0,0,3,1.4085
1991716644473195_2311290069182516,1,0,0,1,0.4927
1991716644473195_2311296079181915,1,0,0,1,0.4927
1991716644473195_2311301079181415,7,0,0,7,3.4163
1991716644473195_2311327622512094,3,0,0,3,1.3212
1991716644473195_2311340585844131,13,2,0,15,5.6122
1991716644473195_2311346195843570,16,8,1,25,9.4893
1991716644473195_2311348475843342,1,0,0,1,0.8176
1991716644473195_2311356942509162,3,0,0,3,1.7237
1991716644473195_2311357369175786,1,0,0,1,0.4404
1991716644473195_2311357529175770,7,0,0,7,3.4626
1991716644473195_2311359482508908,3,0,0,3,1.3735
1991716644473195_2311362282508628,3,0,0,3,1.3212
1991716644473195_2311367889174734,1,0,0,1,0.4404
1991716644473195_2311387509172772,22,2,0,24,9.9454
1991716644473195_2311401855838004,13,6,1,20,6.0409
1991716644473195_2311404145837775,1,0,0,1,0.4404
1991716644473195_2311405219171001,2,0,0,2,0.8834
1991716644473195_2311411622503694,23,2,0,25,11.4631
1991716644473195_2311417389169784,1,0,0,1,0.4404
1991716644473195_2311419965836193,3,0,0,3,1.3023
1991716644473195_2311429032501953,4,0,0,4,1.6635
1991716644473195_2311430042501852,2,2,0,4,0.8619
1991716644473195_2311446702500186,7,0,0,7,2.9979
1991716644473195_2311457465832443,3,2,0,5,1.3562
1991716644473195_2311462775831912,1,0,0,1,0.4404
1991716644473195_2311478809163642,16,0,0,16,8.1295
1991716644473195_2311480502496806,10,0,0,10,4.845
1991716644473195_2311495365828653,6,1,0,7,2.6235
1991716644473195_2311500009161522,3,0,0,3,1.3023
1991716644473195_2311514969160026,19,0,1,20,8.2565
1991716644473195_2311518802492976,9,2,0,11,4.4184
1991716644473195_2311763939135129,6,0,0,6,3.1859
1991716644473195_2311796989131824,5,0,0,5,2.1453
1991716644473195_2311806362464220,4,0,0,4,1.7427
1991716644473195_2311812779130245,13,6,1,20,6.0443
1991716644473195_2311817369129786,6,0,0,6,3.1711
1991716644473195_2311834259128097,3,0,0,3,1.2834
1991716644473195_2311849675793222,7,1,0,8,3.5798
1991716644473195_2311850242459832,4,2,0,6,2.0457
1991716644473195_2311866389124884,4,0,0,4,1.795
1991716644473195_2311874772457379,3,0,0,3,1.6392
1991716644473195_2311877595790430,4,0,0,4,2.3104
1991716644473195_2311880285790161,23,1,0,24,12.3464
1991716644473195_2311884645789725,1,1,0,2,0.4215
1991716644473195_2311993632445493,3,0,0,3,1.3023
1991716644473195_2312051929106330,8,1,0,9,3.7411
1991716644473195_2312055715772618,2,1,0,3,0.8619
1991716644473195_2312092339102289,2,0,0,2,0.8808
1991716644473195_2312100199101503,4,2,0,6,2.3766
1991716644473195_2312113909100132,3,0,0,3,1.3023
1991716644473195_2312123169099206,11,0,0,11,5.2153
1991716644473195_2312124932432363,4,0,0,4,1.795
1991716644473195_2312211725757017,2,1,0,3,0.8808
1991716644473195_2312211939090329,2,0,0,2,0.8619
1991716644473195_2312213725756817,2,0,0,2,0.8808
1991716644473195_2312216049089918,2,1,0,3,1.2835
1991716644473195_2312232042421652,1,0,0,1,0.4404
1991716644473195_2312234659088057,3,0,0,3,1.7613
1991716644473195_2312235405754649,2,0,0,2,1.3876
1991716644473195_2312239692420887,2,0,0,2,0.8619
1991716644473195_2312250625753127,2,1,0,3,0.8619
1991716644473195_2312253922419464,2,0,0,2,1.2778
1991716644473195_2312269529084570,1,0,0,1,0.4404
1991716644473195_2312284809083042,4,0,0,4,1.9795
1991716644473195_2312293692415487,8,0,0,8,3.8202
1991716644473195_2312302039081319,4,0,0,4,2.1562
1991716644473195_2312449615733228,6,0,0,6,3.5589
1991716644473195_2312489032395953,2,1,0,3,0.8808
1991716644473195_2312572942387562,21,4,0,25,11.5136
1991716644473195_2312575539053969,4,0,0,4,1.9272
1991716644473195_2312615179050005,1,0,0,1,0.4215
1991716644473195_2312631629048360,6,0,0,6,3.058
1991716644473195_2312650655713124,3,0,0,3,1.3023
1991716644473195_2312715502373306,3,0,0,3,1.242
1991716644473195_2312730379038485,5,0,0,5,2.1992
1991716644473195_2312757142369142,2,0,0,2,1.266
1991716644473195_2312762205701969,19,6,0,25,9.7728
1991716644473195_2312787522366104,2,0,0,2,1.0653
1991716644473195_2312830602361796,1,2,0,3,0.4215
1991716644473195_2312879262356930,20,5,0,25,10.4745
1991716644473195_2312879622356894,4,0,0,4,1.9272
1991716644473195_2312943475683842,1,0,0,1,0.4404
1991716644473195_2312976625680527,4,0,0,4,1.7049
1991716644473195_2312979079013615,4,2,0,6,1.7238
1991716644473195_2313003829011140,6,1,0,7,2.4261
1991716644473195_2313333505644839,2,0,0,2,0.8808
1991716644473195_2313348655643324,3,1,0,4,1.2827
1991716644473195_2313353712309485,2,0,0,2,0.8808
1991716644473195_2313357285642461,2,0,0,2,0.8619
1991716644473195_2313361748975348,3,0,0,3,1.2834
1991716644473195_2313374658974057,2,0,0,2,0.8808
1991716644473195_2313375185640671,1,0,0,1,0.4404
1991716644473195_2313394565638733,3,0,0,3,1.3212
1991716644473195_2313407482304108,6,3,0,9,3.489
1991716644473195_2313417548969768,4,0,0,4,1.6635
1991716644473195_2313432612301595,2,0,0,2,0.8619
1991716644473195_2313439235634266,2,0,0,2,0.8619
1991716644473195_2313443092300547,3,0,0,3,1.3212
1991716644473195_2313444062300450,2,0,0,2,1.3737
1991716644473195_2313446045633585,5,0,0,5,2.7099
1991716644473195_2313518708959652,6,0,0,6,2.8225
1991716644473195_2313519618959561,1,0,0,1,0.4404
1991716644473195_2313519792292877,3,0,0,3,1.2834
1991716644473195_2313523545625835,2,0,0,2,0.9142
1991716644473195_2313533155624874,11,12,0,23,5.0339
1991716644473195_2313544445623745,1,0,0,1,0.4215
1991716644473195_2313545598956963,4,1,0,5,2.0292
1991716644473195_2313548625623327,12,3,0,15,6.8149
1991716644473195_2313549415623248,3,0,0,3,1.3212
1991716644473195_2313563568955166,4,0,0,4,1.7761
1991716644473195_2313566852288171,5,1,0,6,2.1831
1991716644473195_2313568778954645,7,1,0,8,3.1765
1991716644473195_2313569208954602,5,1,0,6,2.6365
1991716644473195_2313586892286167,19,0,0,19,8.6365
1991716644473195_2313590138952509,1,0,0,1,0.4404
1991716644473195_2313610322283824,5,0,0,5,2.2515
1991716644473195_2313626902282166,3,0,0,3,1.3023
1991716644473195_2313637158947807,5,3,0,8,2.1257
1991716644473195_2313644175613772,1,0,0,1,0.4404
1991716644473195_2313659675612222,19,6,0,25,10.5507
1991716644473195_2313672502277606,2,0,0,2,1.0748
1991716644473195_2313676568943866,2,0,0,2,1.4106
1991716644473195_2313688862275970,1,0,0,1,0.4404
1991716644473195_2313698738941649,15,5,0,20,7.2586
1991716644473195_2313699115608278,5,0,0,5,2.3865
1991716644473195_2313935558917967,13,3,0,16,7.4586
1991716644473195_2314010615577128,2,0,0,2,0.9158
1991716644473195_2314015882243268,2,0,0,2,0.8808
1991716644473195_2314031845575005,2,0,0,2,0.8808
1991716644473195_2314032692241587,1,0,0,1,0.4404
1991716644473195_2314047578906765,4,1,0,5,1.9017
1991716644473195_2314047615573428,1,0,0,1,0.4404
1991716644473195_2314080022236854,6,0,0,6,2.5443
1991716644473195_2314083515569838,5,0,0,5,2.6715
1991716644473195_2314095062235350,2,0,0,2,0.8619
1991716644473195_2314095832235273,1,0,0,1,0.4404
1991716644473195_2314096995568490,3,1,0,4,1.3023
1991716644473195_2314098012235055,5,0,0,5,2.6689
1991716644473195_2314100505568139,2,0,0,2,0.8808
1991716644473195_2314101798901343,1,0,0,1,0.4404
1991716644473195_2314105978900925,22,1,0,23,10.9671
1991716644473195_2314107838900739,4,0,0,4,2.012
1991716644473195_2314108588900664,5,1,0,6,2.3421
1991716644473195_2314109172233939,1,0,0,1,0.4404
1991716644473195_2314113385566851,5,0,0,5,2.7697
1991716644473195_2314114192233437,11,1,0,12,5.0434
1991716644473195_2314114782233378,1,1,0,2,0.4404
1991716644473195_2314117408899782,7,0,0,7,3.0072
1991716644473195_2314125962232260,21,4,0,25,10.5353
1991716644473195_2314127222232134,5,0,0,5,2.3487
1991716644473195_2314132505564939,3,0,0,3,1.2834
1991716644473195_2314144558897067,1,1,0,2,0.4404
1991716644473195_2314147665563423,1,0,0,1,0.4404
1991716644473195_2314156898895833,5,1,0,6,2.2515
1991716644473195_2314163415561848,2,0,0,2,0.9331
1991716644473195_2314171385561051,8,0,0,8,3.3067
1991716644473195_2314189398892583,4,1,0,5,1.7427
1991716644473195_2314195402225316,21,2,0,23,9.1168
1991716644473195_2314212995556890,1,1,0,2,0.4404
1991716644473195_2314213915556798,1,0,0,1,0.4404
1991716644473195_2314220278889495,2,0,0,2,1.0812
1991716644473195_2314228918888631,14,11,0,25,7.0691
1991716644473195_2314229162221940,4,1,0,5,2.1574
1991716644473195_2314230602221796,5,1,0,6,2.1831
1991716644473195_2314237372221119,3,0,0,3,1.3023
1991716644473195_2314240462220810,2,0,0,2,0.8619
1991716644473195_2314248022220054,16,0,0,16,8.17
1991716644473195_2314264625551727,5,0,0,5,2.1831
1991716644473195_2314275788883944,8,1,0,9,4.7382
1991716644473195_2314292212215635,1,0,0,1,0.4404
1991716644473195_2314306888880834,4,0,0,4,1.9203
1991716644473195_2314315652213291,5,0,0,5,2.4524
1991716644473195_2314359752208881,6,3,0,9,2.843
1991716644473195_2314368925541297,10,6,0,16,5.0776
1991716644473195_2314387498872773,4,0,0,4,2.0292
1991716644473195_2314611555517034,1,0,0,1,0.4404
1991716644473195_2314621152182741,2,1,0,3,0.8808
1991716644473195_2314639555514234,1,0,0,1,0.4404
1991716644473195_2314673642177492,6,1,0,7,2.6191
1991716644473195_2314680185510171,2,0,1,3,0.5659
1991716644473195_2314687482176108,18,5,0,23,9.0456
1991716644473195_2314688035509386,1,0,0,1,0.4404
1991716644473195_2314712462173610,2,0,0,2,0.9331
1991716644473195_2314747142170142,7,0,0,7,3.0036
1991716644473195_2314756815502508,11,2,0,13,6.2595
1991716644473195_2314772535500936,2,1,0,3,0.8619
1991716644473195_2314777668833756,5,0,0,5,2.1831
1991716644473195_2314797472165109,6,0,0,6,2.8414
1991716644473195_2314801388831384,16,3,0,19,7.0522
1991716644473195_2314801535498036,8,1,0,9,4.0342
1991716644473195_2314804675497722,10,1,0,11,4.9665
1991716644473195_2314807245497465,2,1,0,3,0.9331
1991716644473195_2314813355496854,5,0,0,5,2.2164
1991716644473195_2314844998827023,1,0,0,1,0.4215
1991716644473195_2314848045493385,1,0,0,1,0.4404
1991716644473195_2314848712159985,4,2,0,6,1.7158
1991716644473195_2314849508826572,3,0,0,3,1.3212
1991716644473195_2314851638826359,2,0,0,2,0.8808
1991716644473195_2314857995492390,5,0,0,5,2.1768
1991716644473195_2314860322158824,1,2,0,3,0.4404
1991716644473195_2314874785490711,3,0,0,3,1.3023
1991716644473195_2314879888823534,5,0,0,5,2.2354
1991716644473195_2314896658821857,10,1,0,11,4.675
1991716644473195_2314912115486978,7,1,0,8,3.5466
1991716644473195_2314930648818458,2,0,0,2,0.8808
1991716644473195_2314931502151706,2,1,0,3,0.8808
1991716644473195_2314950545483135,5,0,0,5,2.1831
1991716644473195_2314959172148939,2,0,0,2,0.8619
1991716644473195_2314974562147400,3,1,0,4,1.3023
1991716644473195_2314975152147341,2,0,0,2,0.9331
1991716644473195_2314977512147105,3,0,0,3,1.3735
1991716644473195_2314977998813723,5,0,0,5,2.4549
1991716644473195_2314978108813712,3,0,0,3,1.3023
1991716644473195_2314979008813622,7,0,0,7,3.1557
1991716644473195_2314980438813479,3,0,0,3,1.4258
1991716644473195_2314986432146213,2,0,0,2,0.8808
1991716644473195_2314986488812874,3,0,0,3,1.3735
1991716644473195_2314986798812843,2,0,0,2,0.8808
1991716644473195_2314988412146015,4,0,0,4,1.7616
1991716644473195_2315005165477673,3,0,0,3,1.3212
1991716644473195_2315016728809850,2,1,0,3,0.9158
1991716644473195_2315019462142910,2,1,0,3,0.8808
1991716644473195_2315033142141542,15,4,0,19,7.1814
1991716644473195_2315034238808099,9,1,0,10,3.9942
1991716644473195_2315058342139022,3,0,0,3,1.3212
1991716644473195_2315062598805263,2,0,0,2,0.8808
1991716644473195_2315068598804663,2,1,0,3,0.8808
1991716644473195_2315072705470919,2,0,0,2,0.8808
1991716644473195_2315072948804228,4,0,0,4,1.83
1991716644473195_2315074485470741,6,3,2,11,2.1951
1991716644473195_2315082798803243,6,0,0,6,2.6569
1991716644473195_2315085642136292,3,0,0,3,1.3735
1991716644473195_2315086435469546,2,0,0,2,0.8808
1991716644473195_2315087632136093,1,0,0,1,0.4404
1991716644473195_2315094505468739,4,0,0,4,1.7427
1991716644473195_2315102012134655,1,1,0,2,0.4404
1991716644473195_2315111988800324,12,1,0,13,5.9445
1991716644473195_2315141982130658,12,0,0,12,6.1748
1991716644473195_2315147185463471,7,1,0,8,3.2159
1991716644473195_2315314262113430,2,1,0,3,0.8808
1991716644473195_2315431198768403,10,3,0,13,5.3487
1991716644473195_2315433565434833,5,0,0,5,2.1642
1991716644473195_2315477712097085,5,0,0,5,2.1831
1991716644473195_2315511845427005,3,0,0,3,1.3212
1991716644473195_2315514622093394,1,0,0,1,0.1779
1991716644473195_2315521378759385,1,1,0,2,0.4404
1991716644473195_2315522268759296,1,0,0,1,0.4404
1991716644473195_2315532178758305,13,1,0,14,6.5596
1991716644473195_2315536128757910,2,1,0,3,0.8619
1991716644473195_2315541638757359,1,0,0,1,0.4404
1991716644473195_2315541982090658,2,0,0,2,0.8619
1991716644473195_2315543518757171,2,1,0,3,0.8808
1991716644473195_2315551572089699,3,0,0,3,1.3212
1991716644473195_2315557052089151,2,0,0,2,0.9331
1991716644473195_2315563112088545,2,0,0,2,0.9158
1991716644473195_2315567988754724,8,2,0,10,3.7156
1991716644473195_2315580208753502,3,0,0,3,1.3023
1991716644473195_2315591808752342,1,0,0,1,0.4404
1991716644473195_2315613902083466,4,0,0,4,1.7616
1991716644473195_2315625862082270,7,2,0,9,3.0973
1991716644473195_2315634495414740,3,0,0,3,1.3212
1991716644473195_2315642662080590,3,2,0,5,1.4802
1991716644473195_2315642802080576,1,0,0,1,0.4404
1991716644473195_2315643208747202,5,0,0,5,2.1245
1991716644473195_2315643542080502,6,0,0,6,2.6424
1991716644473195_2315653042079552,22,3,0,25,10.527
1991716644473195_2315659428745580,5,0,0,5,2.2354
1991716644473195_2315662805411909,3,0,0,3,1.3212
1991716644473195_2315667615411428,3,0,0,3,1.3212
1991716644473195_2315672775410912,2,1,0,3,0.8619
1991716644473195_2315681945409995,6,0,0,6,2.9517
1991716644473195_2315694485408741,3,0,0,3,1.3023
1991716644473195_2315705028741020,18,5,0,23,8.5004
1991716644473195_2315705285407661,4,3,0,7,2.1438
1991716644473195_2315714312073425,2,0,0,2,0.8619
1991716644473195_2315728802071976,1,0,0,1,0.4404
1991716644473195_2315729745405215,4,0,0,4,1.703
1991716644473195_2315739658737557,3,0,0,3,1.3212
1991716644473195_2315739932070863,9,2,0,11,4.2096
1991716644473195_2315766968734826,4,1,0,5,1.7158
1991716644473195_2315770818734441,2,0,0,2,0.9331
1991716644473195_2315781852066671,7,0,0,7,3.1351
1991716644473195_2315794238732099,2,0,0,2,0.8808
1991716644473195_2315796372065219,4,0,0,4,1.6824
1991716644473195_2315797918731731,4,3,0,7,1.9206
1991716644473195_2315798615398328,4,0,0,4,1.9461
1991716644473195_2315803638731159,2,0,0,2,0.8619
1991716644473195_2315809215397268,2,0,0,2,1.0123
1991716644473195_2315822835395906,5,0,0,5,2.571
1991716644473195_2315833208728202,1,1,0,2,0.4404
1991716644473195_2315843495393840,4,0,0,4,1.8473
1991716644473195_2315856755392514,5,0,0,5,2.4081
1991716644473195_2315894205388769,2,1,0,3,0.8808
1991716644473195_2316141725364017,3,0,0,3,1.3546
1991716644473195_2316149628696560,2,0,0,2,0.8808
1991716644473195_2316155885362601,6,1,0,7,2.6585
1991716644473195_2316157785362411,2,0,0,2,0.8619
1991716644473195_2316178172027039,2,0,0,2,0.8808
1991716644473195_2316190952025761,1,1,0,2,0.4404
1991716644473195_2316196005358589,5,0,0,5,2.0159
1991716644473195_2316197402025116,4,1,0,5,2.5655
1991716644473195_2316199512024905,3,0,0,3,1.3212
1991716644473195_2316201052024751,5,0,0,5,2.6772
1991716644473195_2316202405357949,6,1,0,7,2.3649
1991716644473195_2316206052024251,13,3,0,16,6.9906
1991716644473195_2316207585357431,3,0,0,3,1.5699
1991716644473195_2316225068689016,7,1,0,8,3.4461
1991716644473195_2316241072020749,3,0,0,3,1.3023
1991716644473195_2316244518687071,23,2,0,25,10.0486
1991716644473195_2316264035351786,5,3,0,8,2.237
1991716644473195_2316269442017912,3,0,0,3,1.3212
1991716644473195_2316285288682994,7,1,0,8,3.1862
1991716644473195_2316286312016225,20,5,0,25,9.4129
1991716644473195_2316288308682692,4,1,0,5,1.8151
1991716644473195_2316297358681787,6,0,0,6,2.5443
1991716644473195_2316317592013097,4,1,0,5,1.7616
1991716644473195_2316318222013034,2,1,0,3,1.0653
1991716644473195_2316322605345929,6,0,0,6,2.6235
1991716644473195_2316323015345888,6,2,0,8,2.6235
1991716644473195_2316323352012521,1,0,0,1,0.4404
1991716644473195_2316325305345659,3,1,0,4,1.3212
1991716644473195_2316329332011923,11,2,0,13,5.788
1991716644473195_2316330048678518,4,2,0,6,1.7777
1991716644473195_2316337585344431,4,0,0,4,1.7777
1991716644473195_2316351522009704,8,2,0,10,3.5566
1991716644473195_2316361755342014,1,1,0,2,0.4404
1991716644473195_2316362225341967,2,0,0,2,0.8619
1991716644473195_2316365352008321,1,1,0,2,0.4404
1991716644473195_2316404062004450,4,0,0,4,1.9083
1991716644473195_2316421238669399,15,2,0,17,7.8203
1991716644473195_2316445872000269,4,1,0,5,1.7427
1991716644473195_2316493088662214,1,0,0,1,0.4404
1991716644473195_2316502705327919,4,0,0,4,1.7049
1991716644473195_2316509285327261,1,0,0,1,0.4927
1991716644473195_2316512215326968,1,0,0,1,0.4404
1991716644473195_2316512948660228,12,1,0,13,6.1307
1991716644473195_2316514241993432,2,0,0,2,0.8808
1991716644473195_2316516405326549,1,0,0,1,0.4404
1991716644473195_2316528715325318,2,0,0,2,0.8808
1991716644473195_2316532748658248,3,0,0,3,1.3212
1991716644473195_2316534345324755,1,0,0,1,0.4404
1991716644473195_2316540851990771,2,0,0,2,0.9158
1991716644473195_2316551118656411,2,0,0,2,0.8619
1991716644473195_2316560138655509,0,2,0,2,0
1991716644473195_2316561645322025,4,1,0,5,1.7966
1991716644473195_2316568541988002,18,7,0,25,10.5033
1991716644473195_2316573145320875,6,1,0,7,2.8423
1991716644473195_2316576355320554,4,0,0,4,1.8139
1991716644473195_2316621791982677,22,3,0,25,12.0312
1991716644473195_2316642758647247,4,6,0,10,1.9715
1991716644473195_2316734888638034,1,0,0,1,0.4404
1991716644473195_2316865868624936,17,1,0,18,8.1879
1991716644473195_2316899968621526,1,0,0,1,0.7269
1991716644473195_2316937198617803,7,3,0,10,3.0963
1991716644473195_2316940455284144,1,0,0,1,0.4404
1991716644473195_2316940701950786,19,4,0,23,8.6709
1991716644473195_2316941635284026,1,0,0,1,0.4215
1991716644473195_2316953318616191,13,0,0,13,5.8533
1991716644473195_2316965845281605,3,1,0,4,1.6242
1991716644473195_2316969201947936,24,1,0,25,14.5647
1991716644473195_2316980698613453,3,1,0,4,1.2834
1991716644473195_2316981561946700,3,2,0,5,1.3023
1991716644473195_2317008365277353,4,0,0,4,1.7616
1991716644473195_2317013228610200,2,2,0,4,0.8808
1991716644473195_2317019358609587,11,1,0,12,5.2447
1991716644473195_2317025065275683,2,0,0,2,0.9331
1991716644473195_2317030615275128,3,1,0,4,1.2834
1991716644473195_2317038641940992,1,0,0,1,0.4404
1991716644473195_2317044441940412,13,1,0,14,8.1246
1991716644473195_2317047751940081,1,0,0,1,0.4404
1991716644473195_2317058188605704,10,0,0,10,4.433
1991716644473195_2317068768604646,4,0,0,4,1.9206
1991716644473195_2317069608604562,1,0,0,1,0.4404
1991716644473195_2317070985271091,3,1,0,4,1.7705
1991716644473195_2317076688603854,4,1,1,6,1.4817
1991716644473195_2317083378603185,5,0,0,5,2.5463
1991716644473195_2317083668603156,4,4,0,8,1.703
1991716644473195_2317086181936238,4,0,1,5,1.534
1991716644473195_2317119088599614,5,0,0,5,2.1831
1991716644473195_2317142338597289,2,0,0,2,0.8808
1991716644473195_2317142958597227,1,0,0,1,0.4404
1991716644473195_2317145841930272,1,0,0,1,0.4404
1991716644473195_2317150331929823,2,0,0,2,1.0518
1991716644473195_2317152841929572,6,1,0,7,2.6569
1991716644473195_2317179868593536,3,2,0,5,1.3023
1991716644473195_2317183851926471,1,1,0,2,0.4404
1991716644473195_2317202328591290,2,0,0,2,0.8808
1991716644473195_2317212858590237,15,4,0,19,8.1487
1991716644473195_2317252958586227,3,0,0,3,1.2834
1991716644473195_2317290255249164,2,0,0,2,0.8808
1991716644473195_2317326265245563,2,0,0,2,0.8808
1991716644473195_2317330911911765,1,1,0,2,0.4404
1991716644473195_2317353251909531,4,0,0,4,1.8662
1991716644473195_2317388028572720,4,0,0,4,1.795
1991716644473195_2317396525238537,11,2,0,13,5.8796
1991716644473195_2317752218536301,1,1,0,2,0.4404
1991716644473195_2317798681864988,1,0,0,1,0.4404
1991716644473195_2317806631864193,4,2,0,6,2.0642
1991716644473195_2317809128530610,17,5,3,25,7.2443
1991716644473195_2317812428530280,0,1,0,1,0
1991716644473195_2317829955195194,6,1,0,7,2.7251
1991716644473195_2317842848527238,23,2,0,25,11.843
1991716644473195_2317850575193132,6,0,0,6,2.4563
1991716644473195_2317863188525204,5,0,0,5,2.361
1991716644473195_2317880768523446,3,0,0,3,1.3386
1991716644473195_2317880818523441,8,1,0,9,3.3348
1991716644473195_2317891778522345,18,6,1,25,11.2953
1991716644473195_2317893028522220,2,0,0,2,0.9331
1991716644473195_2317893971855459,8,1,0,9,3.9672
1991716644473195_2317944645183725,6,0,0,6,2.6235
1991716644473195_2317952651849591,1,0,0,1,0.4404
1991716644473195_2317985521846304,6,0,0,6,2.8414
1991716644473195_2318150585163131,1,0,0,1,0.4404
1991716644473195_2318155148496008,1,0,0,1,0.4404
1991716644473195_2318160011828855,4,1,0,5,1.7427
1991716644473195_2318160745162115,4,3,0,7,1.9206
1991716644473195_2318215041823352,3,7,0,10,1.5592
1991716644473195_2318398625138327,1,0,0,1,0.4404
1991716644473195_2318409315137258,1,1,0,2,0.4404
1991716644473195_2318435198468003,7,1,0,8,3.0973
1991716644473195_2318436725134517,1,0,0,1,0.4404
1991716644473195_2318437045134485,6,1,0,7,3.172
1991716644473195_2318437805134409,4,1,0,5,1.7616
1991716644473195_2318452085132981,1,0,0,1,0.4404
1991716644473195_2318452625132927,4,0,0,4,1.7427
1991716644473195_2318453105132879,3,0,0,3,1.5616
1991716644473195_2318454058466117,2,1,0,3,1.0123
1991716644473195_2318476471797209,2,0,0,2,0.8423
1991716644473195_2318477545130435,13,1,0,14,7.0431
1991716644473195_2318504915127698,3,0,0,3,1.3023
1991716644473195_2318511051793751,3,1,0,4,1.3212
1991716644473195_2318511935126996,5,1,0,6,2.9063
1991716644473195_2318514848460038,4,0,0,4,1.9556
1991716644473195_2318519591792897,2,0,0,2,1.0653
1991716644473195_2318541191790737,2,0,0,2,0.8619
1991716644473195_2318549745123215,4,0,0,4,1.795
1991716644473195_2318565695121620,6,1,0,7,2.4724
1991716644473195_2318597408451782,4,0,0,4,1.6612
1991716644473195_2318622985115891,5,0,0,5,2.237
1991716644473195_2318633418448181,6,8,0,14,3.1849
1991716644473195_2318633985114791,8,0,0,8,3.8715
1991716644473195_2318637915114398,4,0,0,4,2.0481
1991716644473195_2318661875112002,7,2,0,9,3.1162
1991716644473195_2318671405111049,2,0,0,2,0.9331
1991716644473195_2318681051776751,8,2,0,10,4.4068
1991716644473195_2318687525109437,3,0,0,3,1.3212
1991716644473195_2318700901774766,3,0,0,3,1.3023
1991716644473195_2318703815107808,1,0,0,1,0.4404
1991716644473195_2318749281769928,0,1,0,1,0
1991716644473195_2318757898435733,3,0,0,3,1.3735
1991716644473195_2318770741767782,1,0,0,1,0.4404
1991716644473195_2318814501763406,3,0,0,3,1.3023
1991716644473195_2318831255095064,2,1,0,3,0.8808
1991716644473195_2318857758425747,2,3,0,5,0.8808
1991716644473195_2319065735071616,1,0,0,1,0.4404
1991716644473195_2319097168401806,8,0,0,8,4.1319
1991716644473195_2319125185065671,1,0,0,1,0.4404
1991716644473195_2319195158392007,6,1,0,7,2.83
1991716644473195_2319214408390082,4,0,0,4,1.7777
1991716644473195_2319230521721804,4,0,0,4,1.7616
1991716644473195_2319231875055002,3,0,0,3,1.3212
1991716644473195_2319233641721492,6,0,0,6,2.6581
1991716644473195_2319237031721153,5,0,0,5,2.7391
1991716644473195_2319241571720699,3,1,0,4,1.6432
1991716644473195_2319244965053693,1,0,0,1,0.4404
1991716644473195_2319252055052984,1,0,0,1,0.4404
1991716644473195_2319254418386081,1,0,0,1,0.4404
1991716644473195_2319294451715411,7,0,0,7,3.08
1991716644473195_2319331448378378,3,0,0,3,1.5936
1991716644473195_2319337715044418,5,0,0,5,2.3487
1991716644473195_2319338811710975,4,0,0,4,1.7238
1991716644473195_2319340021710854,3,0,0,3,2.0472
1991716644473195_2319350021709854,1,0,0,1,0.4215
1991716644473195_2319352305042959,5,0,0,5,2.401
1991716644473195_2319361335042056,1,0,0,1,0.4215
1991716644473195_2319374605040729,6,0,0,6,2.4015
1991716644473195_2319376991707157,2,0,0,2,0.8808
1991716644473195_2319377905040399,5,2,0,7,2.286
1991716644473195_2319396571705199,4,0,0,4,1.6635
1991716644473195_2319397688371754,3,0,0,3,1.3023
1991716644473195_2319398578371665,1,0,0,1,0.4404
1991716644473195_2319403151704541,1,0,0,1,0.4404
1991716644473195_2319411208370402,6,1,0,7,2.638
1991716644473195_2319430191701837,1,0,0,1,0.4404
1991716644473195_2319438771700979,1,0,0,1,0.4404
1991716644473195_2319453641699492,1,0,0,1,0.4404
1991716644473195_2319471628364360,1,0,0,1,0.4404
1991716644473195_2319509588360564,4,0,0,4,1.9742
1991716644473195_2319512765026913,7,0,0,7,3.1874
1991716644473195_2319530638358459,2,0,0,2,0.8619
1991716644473195_2319531511691705,2,0,0,2,0.8808
1991716644473195_2319532385024951,2,0,0,2,0.8619
1991716644473195_2319536895024500,5,0,0,5,2.5984
1991716644473195_2319540271690829,3,0,0,3,1.3373
1991716644473195_2319543985023791,1,0,0,1,0.4404
1991716644473195_2319557255022464,1,0,0,1,0.4404
1991716644473195_2319566235021566,1,0,0,1,0.4215
1991716644473195_2319829324995257,19,1,0,20,9.739
1991716644473195_2319836198327903,18,3,0,21,9.1855
1991716644473195_2319839478327575,4,1,0,5,2.2312
1991716644473195_2319839708327552,4,2,0,6,1.8489
1991716644473195_2319844361660420,3,1,0,4,1.3212
1991716644473195_2319845194993670,1,0,0,1,0.4404
1991716644473195_2319848581659998,5,1,0,6,2.361
1991716644473195_2319868804991309,4,2,0,6,2.0078
1991716644473195_2319869441657912,1,1,0,2,0.4927
1991716644473195_2319870434991146,2,0,0,2,0.8619
1991716644473195_2319872648324258,1,0,0,1,0.4404
1991716644473195_2319879858323537,1,1,0,2,0.4404
1991716644473195_2319899824988207,4,0,0,4,1.7427
1991716644473195_2319901931654663,12,4,1,17,4.7229
1991716644473195_2319906464987543,3,1,0,4,1.3212
1991716644473195_2319923118319211,1,0,0,1,0.4404
1991716644473195_2319924034985786,3,0,0,3,1.7474
1991716644473195_2319946018316921,1,0,0,1,0.4404
1991716644473195_2319949278316595,2,1,0,3,0.8619
1991716644473195_2319962794981910,4,0,0,4,1.7238
1991716644473195_2319975054980684,1,0,0,1,0.4404
1991716644473195_2319981361646720,1,0,0,1,0.4404
1991716644473195_2319986611646195,1,1,0,2,0.4404
1991716644473195_2319987574979432,3,0,0,3,1.3546
1991716644473195_2320008048310718,9,0,0,9,4.1721
1991716644473195_2320015821643274,2,0,0,2,0.8808
1991716644473195_2320029308308592,1,0,0,1,0.4215
1991716644473195_2320041724974017,3,0,0,3,1.5715
1991716644473195_2320053034972886,1,0,0,1,0.4404
1991716644473195_2320059904972199,4,0,0,4,1.7427
1991716644473195_2320060278305495,4,0,0,4,1.7588
1991716644473195_2320077174970472,2,0,0,2,0.9171
1991716644473195_2320079314970258,6,2,0,8,2.4107
1991716644473195_2320088531636003,3,0,0,3,1.4802
1991716644473195_2320089408302582,1,0,0,1,0.4404
1991716644473195_2320100474968142,1,0,0,1,0.4404
1991716644473195_2320163158295207,9,0,0,9,3.9258
1991716644473195_2320169351627921,22,2,0,24,10.4365
1991716644473195_2320200904958099,2,0,0,2,0.9648
1991716644473195_2320208101624046,3,0,0,3,1.3212
1991716644473195_2320208774957312,3,1,0,4,1.3212
1991716644473195_2320233254954864,2,1,0,3,0.8808
1991716644473195_2320253251619531,9,1,0,10,4.2566
1991716644473195_2320255128286010,0,1,0,1,0
1991716644473195_2320272461617610,2,0,0,2,0.8619
1991716644473195_2320506278260895,2,0,0,2,0.8808
1991716644473195_2320516868259836,5,0,0,5,2.1992
1991716644473195_2320517864926403,1,0,0,1,0.4215
1991716644473195_2320524214925768,1,0,0,1,0.4404
1991716644473195_2320525308258992,1,0,0,1,0.4404
1991716644473195_2320554234922766,2,0,0,2,0.8619
1991716644473195_2320554874922702,5,0,0,5,2.3227
1991716644473195_2320564088255114,2,0,0,2,0.8619
1991716644473195_2320564868255036,5,0,0,5,2.244
1991716644473195_2320565724921617,2,2,0,4,0.8033
1991716644473195_2320572888254234,7,0,0,7,3.5445
1991716644473195_2320585058253017,1,0,0,1,0.4404
1991716644473195_2320593484918841,1,0,0,1,0.4404
1991716644473195_2320613528250170,21,4,0,25,9.7236
1991716644473195_2320626748248848,12,0,0,12,6.0663
1991716644473195_2320627711582085,2,0,0,2,0.8808
1991716644473195_2320631511581705,2,0,0,2,0.8619
1991716644473195_2320635498247973,3,1,0,4,1.4868
1991716644473195_2320636954914494,3,0,0,3,1.4924
1991716644473195_2320642228247300,17,2,0,19,9.1393
1991716644473195_2320681014910088,2,1,0,3,0.8619
1991716644473195_2320687681576088,4,0,0,4,1.7238
1991716644473195_2320689374909252,3,0,0,3,1.3023
1991716644473195_2320692474908942,1,0,0,1,0.4404
1991716644473195_2320693708242152,2,0,0,2,0.8619
1991716644473195_2320694781575378,1,0,0,1,0.4404
1991716644473195_2320699561574900,14,11,0,25,5.2003
1991716644473195_2320707094907480,2,0,0,2,0.8808
1991716644473195_2320708571573999,2,0,0,2,0.9158
1991716644473195_2320708701573986,2,1,0,3,0.8808
1991716644473195_2320710204907169,2,0,0,2,0.8619
1991716644473195_2320711484907041,1,0,0,1,0.4404
1991716644473195_2320713838240139,5,1,0,6,2.3669
1991716644473195_2320720494906140,3,0,0,3,1.3023
1991716644473195_2320727441572112,2,0,0,2,0.8619
1991716644473195_2320735724904617,4,1,0,5,1.7427
1991716644473195_2320739701570886,1,0,0,1,0.4404
1991716644473195_2320741428237380,8,0,0,8,3.5528
1991716644473195_2320745258236997,1,0,0,1,0.4404
1991716644473195_2320746261570230,3,0,0,3,1.3735
1991716644473195_2320754301569426,2,0,0,2,0.8808
1991716644473195_2320754584902731,1,0,0,1,0.4404
1991716644473195_2320761074902082,1,0,0,1,0.4404
1991716644473195_2320764038235119,1,0,0,1,0.4404
1991716644473195_2320765978234925,1,0,0,1,0.4404
1991716644473195_2320777821567074,1,0,0,1,0.4404
1991716644473195_2320788834899306,2,1,0,3,0.8808
1991716644473195_2320792638232259,17,2,0,19,7.9686
1991716644473195_2320792838232239,5,0,0,5,2.2342
1991716644473195_2320799848231538,9,0,0,9,4.0115
1991716644473195_2320799941564862,19,6,0,25,8.9465
1991716644473195_2320806184897571,7,1,0,8,3.4818
1991716644473195_2320807151564141,2,0,0,2,0.8808
1991716644473195_2320821174896072,2,1,0,3,0.9459
1991716644473195_2320821354896054,6,1,0,7,3.1404
1991716644473195_2320823644895825,7,4,0,11,3.6266
1991716644473195_2320834248228098,4,0,0,4,1.1284
1991716644473195_2320848711559985,2,0,0,2,0.8222
1991716644473195_2320850774893112,4,3,0,7,1.7616
1991716644473195_2320854028226120,7,1,0,8,3.0198
1991716644473195_2320856668225856,4,1,0,5,1.795
1991716644473195_2320859881558868,2,0,0,2,0.8619
1991716644473195_2320866934891496,1,1,0,2,0.4404
1991716644473195_2320868168224706,2,0,0,2,0.8808
1991716644473195_2320872334890956,2,0,0,2,0.8619
1991716644473195_2320888711555985,1,0,0,1,0.4404
1991716644473195_2320893168222206,3,0,0,3,1.3023
1991716644473195_2320900578221465,1,0,0,1,0.4404
1991716644473195_2320902121554644,3,0,0,3,1.3373
1991716644473195_2320904764887713,2,0,0,2,0.8619
1991716644473195_2320905391554317,7,0,0,7,3.0973
1991716644473195_2320915094886680,6,0,0,6,3.5302
1991716644473195_2320922134885976,3,0,0,3,1.3546
1991716644473195_2320926254885564,23,2,0,25,11.4217
1991716644473195_2320927744885415,5,0,0,5,2.2354
1991716644473195_2320932388218284,1,0,0,1,0.4404
1991716644473195_2320953224882867,4,0,0,4,1.5755
1991716644473195_2320959838215539,1,0,0,1,0.4404
1991716644473195_2320962131548643,1,0,0,1,0.4404
1991716644473195_2320969448214578,1,0,0,1,0.4404
1991716644473195_2320976398213883,5,3,0,8,2.1831
1991716644473195_2320976688213854,2,3,0,5,1.0653
1991716644473195_2320980654880124,6,0,0,6,2.6191
1991716644473195_2320989398212583,2,0,0,2,0.8808
1991716644473195_2321006271544229,1,0,0,1,0.4404
1991716644473195_2321007794877410,7,2,0,9,3.6275
1991716644473195_2321220398189483,2,0,0,2,0.8619
1991716644473195_2321230844855105,1,0,0,1,0.4404
1991716644473195_2321271331517723,20,3,0,23,9.5526
1991716644473195_2321275971517259,9,0,0,9,4.7196
1991716644473195_2321315238179999,6,0,0,6,3.1663
1991716644473195_2321328958178627,2,0,0,2,0.9648
1991716644473195_2321341211510735,2,0,0,2,0.8619
1991716644473195_2321347834843406,3,0,0,3,1.199
1991716644473195_2321349618176561,2,0,0,2,0.8619
1991716644473195_2321370864841103,5,0,0,5,2.1976
1991716644473195_2321371191507737,3,0,0,3,1.3023
1991716644473195_2321373821507474,3,3,0,6,1.5427
1991716644473195_2321374171507439,1,0,0,1,0.4404
1991716644473195_2321377228173800,8,0,0,8,3.7198
1991716644473195_2321389731505883,1,0,0,1,0.4404
1991716644473195_2321396034838586,1,0,0,1,0.4404
1991716644473195_2321398658171657,7,3,0,10,3.4073
1991716644473195_2321412828170240,2,0,0,2,0.8619
1991716644473195_2321414558170067,2,0,0,2,0.8808
1991716644473195_2321422748169248,2,0,0,2,0.8619
1991716644473195_2321442161500640,2,0,0,2,0.9158
1991716644473195_2321445261500330,1,0,0,1,0.4404
1991716644473195_2321450918166431,20,5,0,25,11.5447
1991716644473195_2321451084833081,2,0,0,2,0.8808
1991716644473195_2321458028165720,12,1,0,13,5.6358
1991716644473195_2321460574832132,2,0,0,2,0.8808
1991716644473195_2321497961495060,4,0,0,4,1.7777
1991716644473195_2321526648158858,1,0,0,1,0.4404
1991716644473195_2321572001487656,3,0,0,3,1.2834
1991716644473195_2321595954818594,3,0,0,3,1.3023
1991716644473195_2321640974814092,3,1,0,4,1.3212
1991716644473195_2321645438146979,8,1,0,9,4.158
1991716644473195_2321648278146695,1,0,0,1,0.4404
1991716644473195_2321655198146003,22,3,0,25,12.2017
1991716644473195_2321658118145711,5,0,0,5,2.6176
1991716644473195_2321667734811416,2,0,0,2,0.8619
1991716644473195_2321681151476741,5,2,0,7,2.6192
1991716644473195_2321693374808852,3,2,0,5,1.7803
1991716644473195_2321708834807306,1,1,0,2,0.4404
1991716644473195_2321732681471588,15,3,0,18,8.2592
1991716644473195_2321762848135238,3,2,0,5,1.1952
1991716644473195_2321903288121194,1,0,0,1,0.5859
1991716644473195_2321960358115487,6,0,0,6,2.6235
1991716644473195_2321965678114955,2,0,0,2,1.3895
1991716644473195_2321969094781280,1,1,0,2,0.4404
1991716644473195_2321972461447610,11,1,1,13,4.9677
1991716644473195_2321975664780623,1,0,0,1,0.4215
1991716644473195_2321990234779166,2,0,0,2,0.9158
1991716644473195_2321999271444929,2,3,2,7,0.4301
1991716644473195_2322007168110806,1,0,0,1,0.4404
1991716644473195_2322010158110507,1,0,0,1,0.4404
1991716644473195_2322014901443366,2,1,0,3,1.0878
1991716644473195_2322019898109533,1,0,0,1,0.4404
1991716644473195_2322023521442504,1,0,0,1,0.4404
1991716644473195_2322047141440142,1,0,0,1,0.4215
1991716644473195_2322051288106394,3,0,0,3,1.3546
1991716644473195_2322051918106331,4,0,0,4,1.9461
1991716644473195_2322179291426927,2,0,0,2,0.9459
1991716644473195_2322234051421451,1,0,0,1,0.4404
1991716644473195_2322243048087218,3,0,0,3,1.3212
1991716644473195_2322286358082887,1,0,0,1,0.4404
1991716644473195_2322311854747004,9,2,0,11,5.1057
1991716644473195_2322322674745922,2,0,0,2,1.0398
1991716644473195_2322373701407486,1,0,0,1,0.4404
1991716644473195_2322419254736264,4,2,1,7,2.2837
1991716644473195_2322577604720429,2,0,0,2,1.1063
1991716644473195_2322645391380317,1,0,0,1,0.4404
1991716644473195_2322655034712686,2,0,0,2,0.8808
1991716644473195_2322711261373730,2,0,0,2,0.8808
1991716644473195_2322741994703990,1,0,0,1,0.4404
1991716644473195_2322751611369695,1,0,0,1,0.4404
1991716644473195_2322752091369647,2,0,0,2,0.8808
1991716644473195_2322763898035133,1,0,0,1,0.4404
1991716644473195_2322807221364134,12,0,0,12,5.5617
1991716644473195_2322812488030274,1,0,0,1,0.4927
1991716644473195_2322829288028594,2,0,0,2,0.9681
1991716644473195_2322857794692410,3,1,0,4,1.3023
1991716644473195_2322869708024552,2,0,0,2,0.8539
1991716644473195_2322870488024474,4,1,0,5,2.1449
1991716644473195_2322990148012508,1,0,0,1,0.4404
1991716644473195_2323031141341742,7,3,0,10,3.045
1991716644473195_2323119624666227,2,0,0,2,0.8619
1991716644473195_2323123577999165,1,0,0,1,0.4754
1991716644473195_2323392644638925,20,4,1,25,10.1722
1991716644473195_2323489111295945,4,0,0,4,1.7238
1991716644473195_2323510464627143,8,1,0,9,4.1724
1991716644473195_2323542291290627,5,0,0,5,2.1831
1991716644473195_2323736081271248,2,0,0,2,0.8222
1991716644473195_2323804581264398,10,1,0,11,4.5141
1991716644473195_2323847214593468,5,1,0,6,2.202
1991716644473195_2323868517924671,2,1,0,3,0.8808
1991716644473195_2324068831237973,10,0,15,25,-4.2686
1991716644473195_2324186427892880,12,2,1,15,6.2245
1991716644473195_2324189534559236,1,0,0,1,0.4404
1991716644473195_2324192264558963,8,1,0,9,3.7009
1991716644473195_2324211007890422,3,2,0,5,1.4868
1991716644473195_2324223014555888,4,1,0,5,1.5046
1991716644473195_2324243937887129,3,0,0,3,1.3212
1991716644473195_2324278841216972,4,1,0,5,1.4344
1991716644473195_2324279194550270,2,0,0,2,0.9508
1991716644473195_2324281591216697,0,1,0,1,0
1991716644473195_2324296567881866,3,0,0,3,1.3023
1991716644473195_2324304254547764,18,1,0,19,8.1542
1991716644473195_2324307334547456,1,1,0,2,0.4404
1991716644473195_2324313614546828,2,0,0,2,1.2121
1991716644473195_2324322571212599,1,0,0,1,0.4404
1991716644473195_2324322717879251,1,0,0,1,0.4404
1991716644473195_2324325754545614,23,2,0,25,10.9003
1991716644473195_2324329561211900,2,0,0,2,0.8619
1991716644473195_2324333254544864,1,0,0,1,0.4404
1991716644473195_2324339584544231,20,2,0,22,9.71
1991716644473195_2324345157877007,1,0,0,1,0.4404
1991716644473195_2324350991209757,1,0,0,1,0.4404
1991716644473195_2324351534543036,1,0,0,1,0.4404
1991716644473195_2324392981205558,4,0,0,4,1.7427
1991716644473195_2324395904538599,1,0,0,1,0.4404
1991716644473195_2324399571204899,7,0,0,7,4.3329
1991716644473195_2324403287871194,2,0,0,2,0.8808
1991716644473195_2324404481204408,5,0,0,5,2.1831
1991716644473195_2324407741204082,12,0,0,12,7.5208
1991716644473195_2324410677870455,9,3,0,12,4.4982
1991716644473195_2324423241202532,1,0,0,1,0.4404
1991716644473195_2324426641202192,5,4,0,9,2.4215
1991716644473195_2324428134535376,2,0,0,2,0.8808
1991716644473195_2324438937867629,1,0,0,1,0.4404
1991716644473195_2324450291199827,1,0,0,1,0.4404
1991716644473195_2324462467865276,2,0,0,2,0.8808
1991716644473195_2324484567863066,13,0,0,13,6.761
1991716644473195_2324507417860781,6,0,0,6,2.5668
1991716644473195_2324518104526379,1,0,0,1,0.4404
1991716644473195_2324521014526088,19,6,0,25,9.3509
1991716644473195_2324527184525471,4,0,0,4,1.7238
1991716644473195_2324532551191601,4,0,0,4,2.3479
1991716644473195_2324545137857009,2,0,0,2,0.9158
1991716644473195_2324546871190169,2,0,0,2,0.843
1991716644473195_2324547717856751,2,0,0,2,0.8619
1991716644473195_2324558371189019,1,0,0,1,0.4404
1991716644473195_2324567827854740,11,2,0,13,5.2425
1991716644473195_2324578224520367,1,0,0,1,0.4404
1991716644473195_2324842311160625,0,1,0,1,0
1991716644473195_2324867741158082,1,0,0,1,0.4404
1991716644473195_2324942297817293,1,0,0,1,0.4404
1991716644473195_2324954384482751,3,8,0,11,1.3023
1991716644473195_2324974404480749,3,0,0,3,1.8153
1991716644473195_2324984871146369,2,0,0,2,0.8619
1991716644473195_2324985237812999,2,0,0,2,0.8619
1991716644473195_2324989954479194,1,0,0,1,0.4215
1991716644473195_2324989997812523,1,0,0,1,0.4215
1991716644473195_2324990194479170,1,0,0,1,0.4404
1991716644473195_2325003174477872,2,0,0,2,0.8619
1991716644473195_2325006741144182,1,0,0,1,0.4404
1991716644473195_2325024597809063,1,0,0,1,0.4404
1991716644473195_2325040144474175,3,0,0,3,1.6147
1991716644473195_2325045401140316,6,0,0,6,3.0341
1991716644473195_2325046634473526,1,0,0,1,0.4404
1991716644473195_2325073327804190,1,0,0,1,0.4404
1991716644473195_2325095334468656,1,0,0,1,0.4404
1991716644473195_2325151657796357,1,2,0,3,0.6369
1991716644473195_2325183101126546,4,0,0,4,2.1852
1991716644473195_2325221884456001,5,0,0,5,2.1642
1991716644473195_2325253167786206,1,0,0,1,0.6249
1991716644473195_2325268674451322,11,1,0,12,5.3017
1991716644473195_2325290307782492,1,0,0,1,0.4939
1991716644473195_2325293047782218,1,0,0,1,0.4404
1991716644473195_2325312487780274,21,0,0,21,10.2404
1991716644473195_2325360711108785,2,0,0,2,0.8808
1991716644473195_2325544164423773,21,0,0,21,9.9399
1991716644473195_2325580851086771,0,1,0,1,0
1991716644473195_2325623667749156,2,2,0,4,0.8016
1991716644473195_2325635934414596,3,1,0,4,1.3212
1991716644473195_2325636527747870,2,0,0,2,0.8808
1991716644473195_2325640811080775,2,0,0,2,0.8808
1991716644473195_2325675564410633,1,0,0,1,0.4404
1991716644473195_2325701684408021,3,0,0,3,1.4076
1991716644473195_2325712241073632,7,3,0,10,3.3282
1991716644473195_2325732541071602,1,0,0,1,0.4404
1991716644473195_2325738001071056,1,0,0,1,0.5994
1991716644473195_2325743851070471,2,1,0,3,0.8808
1991716644473195_2325778874400302,1,0,0,1,0.4404
1991716644473195_2325786384399551,1,1,0,2,0.4404
1991716644473195_2325842361060620,1,0,0,1,0.4215
1991716644473195_2325852374392952,1,0,0,1,0.4404
1991716644473195_2325942191050637,1,1,0,2,0.4215
1991716644473195_2325962571048599,1,2,0,3,0.4404
1991716644473195_2325970987714424,1,0,0,1,0.5719
1991716644473195_2326000197711503,1,0,0,1,0.4404
1991716644473195_2326185404359649,0,1,0,1,0
1991716644473195_2326185934359596,0,1,0,1,0
1991716644473195_2326186261026230,2,0,0,2,0.8619
1991716644473195_2326264704351719,3,0,0,3,1.4802
1991716644473195_2326328824345307,2,1,0,3,1.2043
1991716644473195_2326338024344387,2,0,0,2,0.8619
1991716644473195_2326340051010851,3,0,0,3,1.3023
1991716644473195_2326345947676928,2,1,0,3,0.8619
1991716644473195_2326373011007555,1,0,0,1,0.4404
1991716644473195_2326378971006959,2,0,0,2,0.8808
1991716644473195_2326380687673454,0,1,0,1,0
1991716644473195_2326386774339512,13,2,0,15,6.7568
1991716644473195_2326406497670873,2,0,0,2,1.3949
1991716644473195_2326408814337308,0,1,1,2,-0.296
1991716644473195_2326416147669908,2,0,0,2,0.8808
1991716644473195_2326416211003235,3,0,0,3,1.3373
1991716644473195_2326417444336445,0,1,0,1,0
1991716644473195_2326419134336276,0,3,1,4,-0.2263
1991716644473195_2326429027668620,7,0,0,7,3.0828
1991716644473195_2326433324334857,3,0,0,3,1.8666
1991716644473195_2326440567667466,1,0,0,1,0.5994
1991716644473195_2326443107667212,1,0,0,1,0.4927
1991716644473195_2326447234333466,21,4,0,25,11.7009
1991716644473195_2326448187666704,2,0,0,2,0.9331
1991716644473195_2326448567666666,2,0,0,2,0.8619
1991716644473195_2326449464333243,1,0,0,1,0.4404
1991716644473195_2326455287665994,1,0,0,1,0.4404
1991716644473195_2326459207665602,7,9,2,18,0.6012
1991716644473195_2326465797664943,1,0,0,1,0.4404
1991716644473195_2326473927664130,1,0,0,1,0.4404
1991716644473195_2326474414330748,1,0,0,1,0.4404
1991716644473195_2326481527663370,1,0,0,1,0.4404
1991716644473195_2326487844329405,2,0,0,2,0.8619
1991716644473195_2326519524326237,3,0,0,3,1.3023
1991716644473195_2326541937657329,3,0,0,3,1.154
1991716644473195_2326543770990479,2,0,0,2,0.8808
1991716644473195_2326553847656138,4,0,0,4,2.2545
1991716644473195_2326559574322232,1,0,0,1,0.4404
1991716644473195_2326574247654098,10,0,0,10,4.3662
1991716644473195_2326624684315721,1,0,0,1,0.9829
1991716644473195_2326638297647693,1,0,0,1,0.4404
1991716644473195_2326657690979087,1,0,0,1,0.4019
1991716644473195_2326658124312377,1,0,0,1,0.4404
1991716644473195_2326660324312157,1,0,0,1,0.4404
1991716644473195_2326663154311874,8,3,0,11,3.9042
1991716644473195_2326672497644273,7,1,0,8,3.5956
1991716644473195_2326678244310365,0,1,0,1,0
1991716644473195_2326691377642385,1,0,0,1,0.4404
1991716644473195_2326691774309012,1,0,0,1,0.4404
1991716644473195_2326699077641615,1,0,0,1,0.4404
1991716644473195_2326704060974450,4,0,0,4,1.7238
1991716644473195_2326751977636325,1,1,0,2,0.5719
1991716644473195_2326920577619465,7,0,0,7,3.0261
1991716644473195_2326953437616179,2,0,0,2,0.8619
1991716644473195_2326954364282753,1,0,0,1,0.4404
1991716644473195_2326955834282606,2,0,0,2,1.0653
1991716644473195_2326956564282533,2,0,0,2,0.8808
1991716644473195_2326959247615598,8,0,0,8,3.8703
1991716644473195_2326961794282010,5,1,0,6,2.3676
1991716644473195_2326978380947018,2,0,0,2,1.0464
1991716644473195_2326994780945378,7,4,0,11,2.9558
1991716644473195_2326996507611872,2,1,0,3,0.8619
1991716644473195_2327001754278014,10,4,0,14,4.7372
1991716644473195_2327003914277798,15,5,0,20,7.6948
1991716644473195_2327009780943878,3,0,0,3,1.3562
1991716644473195_2327011147610408,1,0,0,1,0.4404
1991716644473195_2327015257609997,3,0,0,3,1.3023
1991716644473195_2327023780942478,1,0,0,1,0.4404
1991716644473195_2327039730940883,2,0,0,2,0.9331
1991716644473195_2327048194273370,5,8,0,13,2.237
1991716644473195_2327056884272501,4,1,0,5,1.7616
1991716644473195_2327067660938090,2,0,0,2,0.8808
1991716644473195_2327069970937859,1,0,0,1,0.4404
1991716644473195_2327071530937703,1,0,0,1,0.4404
1991716644473195_2327080644270125,7,15,3,25,2.1847
1991716644473195_2327102977601225,9,1,0,10,4.7671
1991716644473195_2327150754263114,5,1,0,6,2.1075
1991716644473195_2327152290929627,1,0,0,1,0.4404
1991716644473195_2327163087595214,1,0,0,1,0.4404
1991716644473195_2327173017594221,1,0,0,1,0.4404
1991716644473195_2327190694259120,11,2,0,13,5.1807
1991716644473195_2327206700924186,1,1,0,2,0.4019
1991716644473195_2327220177589505,3,0,0,3,1.1579
1991716644473195_2327227320922124,1,0,0,1,0.6249
1991716644473195_2327254950919361,1,2,0,3,0.5994
1991716644473195_2327295607581962,5,0,0,5,2.5058
1991716644473195_2327333110911545,1,6,2,9,-0.1901
1991716644473195_2327336827577840,9,0,0,9,4.1418
1991716644473195_2327337554244434,4,2,0,6,1.7238
1991716644473195_2327351940909662,2,1,0,3,0.8619
1991716644473195_2327353427576180,2,0,0,2,0.8619
1991716644473195_2327354750909381,17,2,0,19,8.7439
1991716644473195_2327392047572318,3,0,0,3,1.6649
1991716644473195_2327393630905493,2,0,0,2,0.8619
1991716644473195_2327403547571168,1,0,0,1,0.4939
1991716644473195_2327416930903163,3,0,0,3,1.3212
1991716644473195_2327425100902346,0,1,0,1,0
1991716644473195_2327657640879092,1,0,0,1,0.6369
1991716644473195_2327735144204675,1,0,0,1,0.4215
1991716644473195_2327796037531919,2,5,1,8,0.5227
1991716644473195_2327846184193571,2,2,0,4,0.8808
1991716644473195_2327918914186298,13,3,0,16,6.8031
1991716644473195_2327984770846379,20,3,2,25,10.2052
1991716644473195_2328002020844654,0,1,0,1,0
1991716644473195_2328037397507783,20,5,0,25,11.4115
1991716644473195_2328074270837429,2,9,4,15,-0.2858
1991716644473195_2328395680805288,21,3,1,25,12.0247
1991716644473195_2328402140804642,1,0,0,1,0.4404
1991716644473195_2328402957471227,11,0,0,11,5.8875
1991716644473195_2328403174137872,5,0,0,5,2.2515
1991716644473195_2328410964137093,0,1,0,1,0
1991716644473195_2328414190803437,2,0,0,2,0.8619
1991716644473195_2328417264136463,2,0,0,2,0.8619
1991716644473195_2328418417469681,5,0,0,5,2.2165
1991716644473195_2328422004135989,1,4,1,6,0.137
1991716644473195_2328435087468014,2,3,0,5,0.9321
1991716644473195_2328460864132103,5,14,0,19,2.0864
1991716644473195_2328462194131970,3,0,0,3,1.3212
1991716644473195_2328487370796119,1,1,0,2,0.8805
1991716644473195_2328510200793836,1,0,0,1,0.4215
1991716644473195_2328542837457239,2,0,0,2,1.2249
1991716644473195_2328629057448617,8,0,0,8,3.6605
1991716644473195_2328636567447866,3,0,0,3,1.3212
1991716644473195_2328643497447173,4,0,0,4,1.8267
1991716644473195_2328649420779914,4,0,0,4,1.7761
1991716644473195_2328734487438074,1,0,0,1,0.4215
1991716644473195_2328745004103689,0,1,0,1,0
1991716644473195_2328746447436878,5,0,0,5,2.3421
1991716644473195_2328754500769406,1,0,0,1,0.4404
1991716644473195_2328781860766670,9,0,0,9,4.3229
1991716644473195_2328812584096931,0,2,0,2,0
1991716644473195_2329087370736119,6,0,0,6,3.7821
1991716644473195_2329094657402057,1,0,0,1,0.4404
1991716644473195_2329126944065495,1,0,0,1,0.4404
1991716644473195_2329174544060735,0,1,0,1,0
1991716644473195_2329177000727156,1,0,0,1,0.4404
1991716644473195_2329177537393769,2,0,0,2,0.8619
1991716644473195_2329178564060333,3,0,0,3,1.3212
1991716644473195_2329187714059418,8,4,0,12,3.0334
1991716644473195_2329192024058987,2,0,0,2,0.8016
1991716644473195_2329204160724440,2,1,0,3,0.9694
1991716644473195_2329213427390180,10,0,0,10,4.6046
1991716644473195_2329224954055694,0,1,1,2,-0.296
1991716644473195_2329235257387997,2,0,0,2,0.8619
1991716644473195_2329240687387454,5,1,0,6,2.4547
1991716644473195_2329254587386064,0,1,0,1,0
1991716644473195_2329264084051781,7,0,0,7,3.2115
1991716644473195_2329265924051597,17,6,0,23,9.2193
1991716644473195_2329285540716302,14,1,1,16,6.1269
1991716644473195_2329295657381957,1,0,0,1,0.7964
1991716644473195_2329323267379196,1,0,0,1,0.4404
1991716644473195_2329329374045252,10,0,0,10,4.1615
1991716644473195_2329333490711507,5,0,0,5,2.1992
1991716644473195_2329338420711014,2,0,0,2,0.8808
1991716644473195_2329346387376884,1,0,0,1,0.4404
1991716644473195_2329354410709415,5,1,0,6,2.1928
1991716644473195_2329448370700019,2,0,0,2,0.9934
1991716644473195_2329451427366380,10,2,1,13,3.025
1991716644473195_2329480204030169,11,3,0,14,3.5521
1991716644473195_2329480347363488,2,0,0,2,0.8619
1991716644473195_2329480897363433,8,1,0,9,3.8745
1991716644473195_2329482864029903,3,0,0,3,1.7223
1991716644473195_2329512810693575,3,0,0,3,1.3023
1991716644473195_2329682114009978,1,0,0,1,0.4404
1991716644473195_2329706687340854,2,0,0,2,0.843
1991716644473195_2329754850669371,3,2,0,5,1.9518
1991716644473195_2329806613997528,3,0,0,3,1.3373
1991716644473195_2329841767327346,0,1,0,1,0
1991716644473195_2329866433991546,2,2,0,4,1.1299
1991716644473195_2329873830657473,1,0,0,1,0.4404
1991716644473195_2329921983985991,24,1,0,25,11.2529
1991716644473195_2329922767319246,0,2,0,2,0
1991716644473195_2329926467318876,6,1,0,7,2.7636
1991716644473195_2329957513982438,3,2,1,6,1.2066
1991716644473195_2329959753982214,2,0,0,2,0.8808
1991716644473195_2329960787315444,9,1,0,10,4.3271
1991716644473195_2329963853981804,1,0,0,1,0.4404
1991716644473195_2329964210648435,1,0,0,1,0.4404
1991716644473195_2329972183980971,1,0,0,1,0.4215
1991716644473195_2329981667313356,3,0,0,3,1.3023
1991716644473195_2330008497310673,1,0,0,1,0.4404
1991716644473195_2330009043977285,2,9,0,11,1.0263
1991716644473195_2330014323976757,0,2,0,2,0
1991716644473195_2330014670643389,1,0,0,1,0.4404
1991716644473195_2330038627307660,7,0,0,7,3.5425
1991716644473195_2330045680640288,7,2,1,10,3.0296
1991716644473195_2330045753973614,20,5,0,25,8.2913
1991716644473195_2330058467305676,5,1,0,6,2.2165
1991716644473195_2330085527302970,2,7,2,11,1.5645
1991716644473195_2330106670634189,6,1,0,7,2.6569
1991716644473195_2330113587300164,1,5,0,6,0.6705
1991716644473195_2330115603966629,6,2,0,8,2.7702
1991716644473195_2330120607299462,1,0,0,1,0.4404
1991716644473195_2330122980632558,15,2,0,17,7.2469
1991716644473195_2330142810630575,1,2,0,3,0.4588
1991716644473195_2330150390629817,4,0,0,4,1.8151
1991716644473195_2330153383962851,3,1,0,4,1.3735
1991716644473195_2330155487295974,5,10,1,16,3.0031
1991716644473195_2330171107294412,1,0,0,1,0.4404
1991716644473195_2330175177294005,1,0,0,1,0.4404
1991716644473195_2330181610626695,5,7,1,13,1.8184
1991716644473195_2330183130626543,6,0,0,6,2.5668
1991716644473195_2330198580624998,5,0,0,5,2.2181
1991716644473195_2330203820624474,4,0,0,4,1.7238
1991716644473195_2330208983957291,4,0,0,4,1.8828
1991716644473195_2330210617290461,5,0,0,5,2.1642
1991716644473195_2330219130622943,2,0,0,2,1.2526
1991716644473195_2330455743932615,3,0,0,3,1.3558
1991716644473195_2330488903929299,2,0,0,2,0.887
1991716644473195_2330500693928120,1,0,0,1,0.4404
1991716644473195_2330514423926747,7,0,0,7,3.2283
1991716644473195_2330516617259861,8,2,0,10,4.3251
1991716644473195_2330535647257958,2,0,0,2,0.8808
1991716644473195_2330536067257916,0,1,0,1,0
1991716644473195_2330544417257081,2,1,0,3,0.6364
1991716644473195_2330552117256311,4,1,0,5,1.6105
1991716644473195_2330556837255839,3,17,4,24,0.391
1991716644473195_2330560880588768,3,0,0,3,1.3023
1991716644473195_2330570493921140,4,2,0,6,2.592
1991716644473195_2330593223918867,3,0,0,3,1.5169
1991716644473195_2330595603918629,3,0,0,3,1.3023
1991716644473195_2330602273917962,1,0,0,1,0.4404
1991716644473195_2330616383916551,2,0,0,2,0.8808
1991716644473195_2330617713916418,1,4,1,6,-0.1911
1991716644473195_2330635287247994,18,0,1,19,9.1076
1991716644473195_2330648897246633,21,4,0,25,10.518
1991716644473195_2330649370579919,19,6,0,25,10.3477
1991716644473195_2330654027246120,1,1,0,2,0.6249
1991716644473195_2330764707235052,4,1,0,5,2.4331
1991716644473195_2330765217235001,6,0,1,7,2.361
1991716644473195_2330765827234940,2,0,0,2,0.8619
1991716644473195_2330778883900301,2,0,0,2,0.8808
1991716644473195_2330779087233614,1,2,0,3,0.4404
1991716644473195_2330780810566775,2,0,0,2,0.9142
1991716644473195_2330781437233379,2,0,0,2,0.9331
1991716644473195_2330797753898414,1,0,0,1,0.4404
1991716644473195_2330810633897126,4,1,1,6,1.7969
1991716644473195_2330812880563568,2,0,0,2,0.8808
1991716644473195_2330815253896664,3,1,0,4,1.4802
1991716644473195_2330820210562835,5,1,0,6,2.0792
1991716644473195_2330873783890811,11,5,1,17,5.3125
1991716644473195_2330897133888476,13,3,0,16,4.0154
1991716644473195_2330945310550325,3,1,0,4,1.5692
1991716644473195_2330963843881805,4,2,0,6,1.9729
1991716644473195_2330980510546805,1,0,0,1,0.4404
1991716644473195_2331251223853067,2,1,0,3,0.951
1991716644473195_2331279633850226,1,0,0,1,0.4404
1991716644473195_2331296247181898,1,0,0,1,0.4404
1991716644473195_2331338357177687,3,2,0,5,0.9391
1991716644473195_2331354020509454,1,2,0,3,0.4404
1991716644473195_2331357630509093,21,4,0,25,9.3647
1991716644473195_2331363807175142,3,0,0,3,1.4802
1991716644473195_2331381110506745,3,0,0,3,1.3212
1991716644473195_2331389727172550,0,1,0,1,0
1991716644473195_2331400663838123,6,0,0,6,3.2538
1991716644473195_2331510770493779,9,3,0,12,4.2799
1991716644473195_2331543303823859,10,0,0,10,4.7841
1991716644473195_2331595060485350,8,0,0,8,3.7596
1991716644473195_2331617277149795,2,2,0,4,0.9331
1991716644473195_2331633573814832,5,2,0,7,2.237
1991716644473195_2331634753814714,4,0,0,4,1.7616
1991716644473195_2331672590477597,4,3,0,7,1.7777
1991716644473195_2331675393810650,2,2,0,4,1.0765
1991716644473195_2331705223807667,1,0,0,1,0.4404
1991716644473195_2331714073806782,1,0,0,1,0.4404
1991716644473195_2331971330447723,2,0,0,2,0.9854
1991716644473195_2332132607098262,7,1,0,8,3.3665
1991716644473195_2332136307097892,1,0,0,1,0.6597
1991716644473195_2332188333759356,6,3,0,9,2.918
1991716644473195_2332399303738259,1,0,0,1,0.4404
1991716644473195_2332422817069241,1,0,0,1,0.4215
1991716644473195_2332426540402202,1,1,0,2,0.4927
1991716644473195_2332427010402155,2,0,0,2,0.8808
1991716644473195_2332455460399310,3,0,0,3,1.3212
1991716644473195_2332464730398383,2,0,0,2,0.7175
1991716644473195_2332745277036995,3,0,0,3,1.3023
1991716644473195_2332811580363698,7,2,2,11,3.3558
1991716644473195_2332904483687741,1,0,0,1,0.4215
1991716644473195_2332998183678371,3,0,0,3,1.3546
1991716644473195_2333001437011379,8,0,0,8,3.7738
1991716644473195_2333015650343291,2,2,1,5,0.895
1991716644473195_2333175983660591,0,2,0,2,0
1991716644473195_2333447420300114,8,0,1,9,3.3928
1991716644473195_2333453113632878,2,0,0,2,0.8808
1991716644473195_2333459830298873,3,0,0,3,1.3196
1991716644473195_2333474913630698,12,1,0,13,6.423
1991716644473195_2333521213626068,1,1,1,3,0.0235
1991716644473195_2333538306957692,1,1,0,2,0.4404
1991716644473195_2333551453623044,21,4,0,25,9.8539
1991716644473195_2333576196953903,2,0,0,2,0.8808
1991716644473195_2333608073617382,10,1,0,11,5.3848
1991716644473195_2333623480282508,6,2,0,8,2.8959
1991716644473195_2333625270282329,3,0,0,3,1.7497
1991716644473195_2333637376947785,4,1,0,5,1.5299
1991716644473195_2333735176938005,2,0,0,2,0.6947
1991716644473195_2334188080226048,7,0,0,7,3.0973
1991716644473195_2334194886892034,6,0,0,6,2.6903
1991716644473195_2334210273557162,3,5,0,8,1.4613
1991716644473195_2334212703556919,3,0,0,3,1.3023
1991716644473195_2334247133553476,0,2,0,2,0
1991716644473195_2334248466886676,0,4,0,4,0
1991716644473195_2334252030219653,5,0,0,5,2.3421
1991716644473195_2334255840219272,7,1,0,8,3.1954
1991716644473195_2334281280216728,8,4,2,14,3.0524
1991716644473195_2334281833550006,15,2,0,17,7.2683
1991716644473195_2334300296881493,2,0,0,2,1.1673
1991716644473195_2334302383547951,5,0,0,5,2.1453
1991716644473195_2334314740213382,5,1,0,6,2.1675
1991716644473195_2334331230211733,6,2,0,8,2.8269
1991716644473195_2334332733544916,1,0,0,1,0.6239
1991716644473195_2334345133543676,1,0,0,1,0.4404
1991716644473195_2334371873541002,2,5,1,8,0.547
1991716644473195_2334408426870680,1,0,0,1,0.4404
1991716644473195_2334481766863346,3,3,0,6,1.3212
1991716644473195_2334495853528604,1,0,0,1,0.4404
1991716644473195_2334524206859102,4,2,0,6,1.9454
1991716644473195_2334581033520086,4,2,0,6,1.7427
1991716644473195_2334584826853040,2,0,0,2,0.8619
1991716644473195_2334587490186107,1,1,0,2,0.6369
1991716644473195_2334598183518371,1,3,0,4,0.4404
1991716644473195_2334606540184202,3,1,0,4,1.5218
1991716644473195_2334847113493478,24,1,0,25,12.7646
1991716644473195_2334886026822920,5,0,0,5,2.202
1991716644473195_2334913196820203,2,0,0,2,0.8808
1991716644473195_2334913413486848,3,0,0,3,1.6988
1991716644473195_2334949826816540,2,0,0,2,0.8619
1991716644473195_2334955210149335,1,0,0,1,0.4404
1991716644473195_2334995173478672,9,0,0,9,4.0678
1991716644473195_2335009646810558,23,2,0,25,11.663
1991716644473195_2335017260143130,4,0,0,4,1.3192
1991716644473195_2335022740142582,2,1,0,3,0.7804
1991716644473195_2335052733472916,3,0,0,3,1.8729
1991716644473195_2335061593472030,1,0,0,1,0.4404
1991716644473195_2335064136805109,6,1,0,7,2.677
1991716644473195_2335101063468083,3,0,0,3,1.5916
1991716644473195_2335103766801146,1,0,0,1,0.4404
1991716644473195_2335120430132813,1,1,1,3,0.3034
1991716644473195_2335120713466118,4,0,0,4,2.153
1991716644473195_2335159483462241,1,0,0,1,0.4404
1991716644473195_2335174010127455,1,0,0,1,0.4019
1991716644473195_2335182626793260,4,0,0,4,1.7427
1991716644473195_2335205933457596,1,0,0,1,0.4404
1991716644473195_2335210376790485,3,0,0,3,1.3212
1991716644473195_2335213653456824,1,0,0,1,0.4404
1991716644473195_2335225426788980,10,1,0,11,3.9652
1991716644473195_2335230816788441,1,1,0,2,0.4927
1991716644473195_2335233906788132,14,3,0,17,7.2255
1991716644473195_2335491053429084,2,0,0,2,0.9331
1991716644473195_2335502203427969,21,3,1,25,10.9737
1991716644473195_2335544100090446,6,2,0,8,2.7797
1991716644473195_2335558830088973,1,1,0,2,0.4019
1991716644473195_2335564420088414,0,1,0,1,0
1991716644473195_2335565143421675,1,0,0,1,0.5994
1991716644473195_2335576470087209,1,0,0,1,0.3612
1991716644473195_2335584680086388,3,0,0,3,1.3896
1991716644473195_2335588450086011,1,0,0,1,0.4404
1991716644473195_2335595496751973,5,0,0,5,2.3723
1991716644473195_2335599473418242,4,0,0,4,1.7238
1991716644473195_2335605686750954,5,1,0,6,2.5764
1991716644473195_2335615840083272,3,0,0,3,1.3735
1991716644473195_2335617813416408,3,0,0,3,1.3546
1991716644473195_2335622096749313,2,0,0,2,1.0339
1991716644473195_2335625443415645,2,1,0,3,0.8969
1991716644473195_2335626096748913,1,0,0,1,0.4404
1991716644473195_2335630440081812,1,1,0,2,0.7351
1991716644473195_2335635953414594,2,1,0,3,0.7364
1991716644473195_2335646536746869,1,0,0,1,0.4404
1991716644473195_2335654466746076,8,1,0,9,3.5916
1991716644473195_2335655090079347,9,8,1,18,3.9636
1991716644473195_2335655336745989,0,1,0,1,0
1991716644473195_2335659766745546,5,0,0,5,2.2165
1991716644473195_2335666490078207,3,0,0,3,1.3915
1991716644473195_2335667843411405,4,0,0,4,1.9272
1991716644473195_2335668003411389,2,0,0,2,0.8808
1991716644473195_2335671026744420,1,0,0,1,0.4404
1991716644473195_2335673713410818,3,0,0,3,1.498
1991716644473195_2335680850076771,4,4,0,8,2.6056
1991716644473195_2335682313409958,4,2,0,6,1.7588
1991716644473195_2335683390076517,1,0,0,1,0.4404
1991716644473195_2335683993409790,1,0,0,1,0.4404
1991716644473195_2335685803409609,1,0,0,1,0.4404
1991716644473195_2335695063408683,5,3,1,9,1.8473
1991716644473195_2335708083407381,6,0,0,6,2.5857
1991716644473195_2335711183407071,2,0,0,2,0.8808
1991716644473195_2335713396740183,1,3,0,4,0.8442
1991716644473195_2335722626739260,5,0,0,5,2.5528
1991716644473195_2335723826739140,1,0,0,1,0.4404
1991716644473195_2335729093405280,1,0,0,1,0.4404
1991716644473195_2335734816738041,13,3,0,16,6.9045
1991716644473195_2335734976738025,4,1,0,5,1.7049
1991716644473195_2335770563401133,1,1,0,2,0.4404
1991716644473195_2335809326730590,10,0,0,10,4.5763
1991716644473195_2335846810060175,3,1,0,4,1.4919
1991716644473195_2335868160058040,1,1,0,2,0.3182
1991716644473195_2335874703390719,9,1,0,10,4.6312
1991716644473195_2335900486721474,1,0,0,1,0.4404
1991716644473195_2335918533386336,1,2,0,3,0.4404
1991716644473195_2336257200019136,3,1,0,4,1.3023
1991716644473195_2336258570018999,1,0,0,1,0.4404
1991716644473195_2336271693351020,22,2,1,25,11.0274
1991716644473195_2336331530011703,2,0,0,2,0.8808
1991716644473195_2336349396676583,7,2,0,9,3.2578
1991716644473195_2336354153342774,2,0,0,2,0.8808
1991716644473195_2336374823340707,6,1,0,7,2.7863
1991716644473195_2336385830006273,0,1,0,1,0
1991716644473195_2336406993337490,6,1,0,7,2.6919
1991716644473195_2336417533336436,1,0,0,1,0.4215
1991716644473195_2336423656669157,4,0,0,4,1.9017
1991716644473195_2336425683335621,2,0,0,2,0.933
1991716644473195_2336435703334619,21,2,0,23,9.9536
1991716644473195_2336454606666062,1,3,0,4,0.0772
1991716644473195_2336462409998615,19,6,0,25,9.5897
1991716644473195_2336469519997904,2,1,0,3,0.8016
1991716644473195_2336474279997428,3,0,0,3,2.109
1991716644473195_2336476856663837,6,1,0,7,3.3111
1991716644473195_2336478846663638,1,0,0,1,0.4404
1991716644473195_2336486763329513,2,0,0,2,0.8808
1991716644473195_2336491859995670,4,0,0,4,2.5161
1991716644473195_2336506689994187,2,0,0,2,0.8619
1991716644473195_2336507223327467,20,5,0,25,10.2481
1991716644473195_2336513876660135,2,0,0,2,0.9331
1991716644473195_2336528686658654,4,0,0,4,1.8662
1991716644473195_2336530239991832,3,1,0,4,2.1357
1991716644473195_2336534266658096,7,2,0,9,4.3747
1991716644473195_2336542599990596,3,0,0,3,1.5057
1991716644473195_2336549963323193,1,0,0,1,0.4404
1991716644473195_2336550059989850,6,0,0,6,3.0814
1991716644473195_2336563879988468,1,0,0,1,0.4927
1991716644473195_2336565403321649,1,3,0,4,0.4404
1991716644473195_2336599406651582,4,0,0,4,1.6635
1991716644473195_2336622443315945,3,0,0,3,1.3023
1991716644473195_2336630579981798,2,0,0,2,0.8808
1991716644473195_2336672593310930,15,5,0,20,8.7108
1991716644473195_2336674373310752,6,0,0,6,3.012
1991716644473195_2336826983295491,1,0,0,1,0.4404
1991716644473195_2336886569956199,1,0,0,1,0.4404
1991716644473195_2336913689953487,1,0,0,1,0.4404
1991716644473195_2336954783282711,4,0,0,4,1.8127
1991716644473195_2336955069949349,6,2,0,8,2.7702
1991716644473195_2336986436612879,12,1,0,13,6.0761
1991716644473195_2336989536612569,3,1,0,4,1.8232
1991716644473195_2336999229944933,5,0,0,5,2.2543
1991716644473195_2337017946609728,10,0,0,10,4.8363
1991716644473195_2337019876609535,5,0,0,5,1.9611
1991716644473195_2337020006609522,4,0,0,4,2.4961
1991716644473195_2337038716607651,17,8,0,25,8.8498
1991716644473195_2337048409940015,5,0,0,5,2.7477
1991716644473195_2337065239938332,4,0,0,4,1.9725
1991716644473195_2337069409937915,5,1,0,6,2.7924
1991716644473195_2337097963268393,1,0,0,1,0.4404
1991716644473195_2337127759932080,3,1,0,4,1.1351
1991716644473195_2337145546596968,2,0,0,2,0.8808
1991716644473195_2337207313257458,2,0,0,2,0.7136
1991716644473195_2337219353256254,3,1,0,4,1.3212
1991716644473195_2337230066588516,2,0,0,2,1.0992
1991716644473195_2337236716587851,4,0,0,4,1.4352
1991716644473195_2337268336584689,6,1,0,7,2.6396
1991716644473195_2337281219916734,4,1,0,5,2.2125
1991716644473195_2337287329916123,3,0,0,3,1.9837
1991716644473195_2337297606581762,13,1,0,14,6.756
1991716644473195_2337307989914057,2,0,0,2,1.0748
1991716644473195_2337364843241705,2,0,0,2,0.9158
1991716644473195_2337548263223363,1,2,0,3,0.4497
1991716644473195_2337659019878954,1,0,0,1,0.4404
1991716644473195_2337660573212132,2,0,0,2,0.8619
1991716644473195_2337799166531606,1,0,0,1,0.4404
1991716644473195_2337847669860089,8,15,2,25,2.4142
1991716644473195_2337858549859001,4,0,0,4,1.8456
1991716644473195_2337861536525369,0,0,1,1,-0.4466
1991716644473195_2337866579858198,3,0,0,3,1.3212
1991716644473195_2338021396509383,4,0,0,4,1.3606
1991716644473195_2338032099841646,2,0,0,2,1.0992
1991716644473195_2338072799837576,16,8,1,25,7.161
1991716644473195_2338264326485090,2,0,0,2,0.8808
1991716644473195_2338298483148341,7,1,0,8,3.732
1991716644473195_2338344579810398,1,0,0,1,0.9705
1991716644473195_2338387303139459,19,6,0,25,11.0376
1991716644473195_2338509139793942,4,0,0,4,2.0682
1991716644473195_2339027329742123,6,1,0,7,2.9292
1991716644473195_2339111479733708,1,1,0,2,0.5859
1991716644473195_2339134489731407,9,3,0,12,4.7124
1991716644473195_2339148619729994,1,0,0,1,0.4404
1991716644473195_2339175783060611,2,0,0,2,0.8808
1991716644473195_2339208359724020,1,0,0,1,0.4404
1991716644473195_2339222186389304,1,0,0,1,0.4404
1991716644473195_2339223359722520,6,1,0,7,3.6899
1991716644473195_2339235026388020,5,1,0,6,2.7313
1991716644473195_2339266163051573,8,2,0,10,3.7144
1991716644473195_2339281789716677,20,5,0,25,9.5629
1991716644473195_2339284069716449,7,2,0,9,3.8576
1991716644473195_2339392343038955,1,0,0,1,0.4215
1991716644473195_2339419266369596,6,1,0,7,2.6919
1991716644473195_2339429746368548,7,1,0,8,4.5677
1991716644473195_2339467036364819,0,1,0,1,0
1991716644473195_2339523706359152,3,0,0,3,1.5528
1991716644473195_2339589669685889,3,1,0,4,1.3558
1991716644473195_2339769556334567,1,0,0,1,0.4404
1991716644473195_2339812512996938,18,4,0,22,9.3351
1991716644473195_2339825772995612,1,0,0,1,0.4404
1991716644473195_2339830999661756,13,0,0,13,6.7393
1991716644473195_2339837716327751,1,0,0,1,0.4404
1991716644473195_2339838339661022,1,0,0,1,0.4404
1991716644473195_2339848342993355,6,0,0,6,2.2603
1991716644473195_2339876769657179,2,0,0,2,0.8808
1991716644473195_2339878306323692,1,0,0,1,0.4404
1991716644473195_2339881106323412,2,0,0,2,0.8808
1991716644473195_2339886279656228,2,0,0,2,0.8808
1991716644473195_2339887796322743,1,0,0,1,0.4404
1991716644473195_2339898082988381,18,7,0,25,8.9885
1991716644473195_2339926529652203,1,0,0,1,0.4404
1991716644473195_2339949909649865,1,1,0,2,0.4404
1991716644473195_2339972006314322,3,1,0,4,1.3562
1991716644473195_2339994126312110,1,0,0,1,0.4404
1991716644473195_2340007492977440,4,0,0,4,2.5251
1991716644473195_2340022039642652,1,0,0,1,0.3869
1991716644473195_2340058426305680,3,0,0,3,1.2645
1991716644473195_2340097312968458,8,0,0,8,3.3371
1991716644473195_2340149872963202,1,0,0,1,0.4404
1991716644473195_2340180679626788,5,0,0,5,3.2982
1991716644473195_2340204079624448,12,1,0,13,5.3153
1991716644473195_2340206469624209,2,0,0,2,1.0209
1991716644473195_2340229999621856,2,0,0,2,1.1261
1991716644473195_2340467092931480,1,0,1,2,0.0748
1991716644473195_2340529746258548,6,1,0,7,2.9662
1991716644473195_2340534392924750,2,1,0,3,0.8808
1991716644473195_2340566686254854,2,0,0,2,1.1123
1991716644473195_2340586826252840,1,0,0,1,0.4215
1991716644473195_2340590896252433,1,0,0,1,0.4404
1991716644473195_2340611976250325,2,1,0,3,0.9331
1991716644473195_2340620436249479,1,0,0,1,0.4404
1991716644473195_2340628582915331,9,3,0,12,4.0937
1991716644473195_2340635019581354,6,3,0,9,3.2945
1991716644473195_2340644682913721,2,0,0,2,0.8969
1991716644473195_2340646076246915,1,0,0,1,0.4404
1991716644473195_2340654682912721,1,0,0,1,0.4404
1991716644473195_2340667552911434,1,0,0,1,0.4404
1991716644473195_2340674932910696,1,5,0,6,0.4404
1991716644473195_2340701122908077,7,0,0,7,4.6387
1991716644473195_2340721549572701,2,0,0,2,0.8619
1991716644473195_2340722509572605,0,6,1,7,-0.296
1991716644473195_2340722846239238,4,2,0,6,1.6824
1991716644473195_2340725632905626,1,0,0,1,0.4215
1991716644473195_2340740219570834,2,0,0,2,1.0398
1991716644473195_2340744066237116,2,0,0,2,1.0123
1991716644473195_2340749546236568,0,1,0,1,0
1991716644473195_2340751152903074,1,0,0,1,0.4404
1991716644473195_2340762536235269,2,0,0,2,1.0889
1991716644473195_2340768736234649,6,1,0,7,2.9831
1991716644473195_2340773202900869,12,2,0,14,6.1175
1991716644473195_2340773642900825,1,0,0,1,0.4404
1991716644473195_2340776109567245,1,0,0,1,0.4404
1991716644473195_2340784402899749,1,0,0,1,0.4404
1991716644473195_2340786722899517,1,0,0,1,0.4404
1991716644473195_2340788516232671,1,0,0,1,0.4404
1991716644473195_2340789526232570,1,0,0,1,0.4404
1991716644473195_2340789759565880,0,1,0,1,0
1991716644473195_2340790039565852,5,0,0,5,2.2974
1991716644473195_2340791119565744,3,1,1,5,1.5842
1991716644473195_2340793332898856,11,0,0,11,6.7723
1991716644473195_2340793746232148,1,0,0,1,0.7783
1991716644473195_2340803852897804,5,1,0,6,2.6303
1991716644473195_2340821269562729,1,0,0,1,0.4404
1991716644473195_2340843076227215,1,0,0,1,0.4404
1991716644473195_2340891259555730,1,0,0,1,0.4215
1991716644473195_2340901239554732,2,0,0,2,0.8619
1991716644473195_2340911462887043,1,0,0,1,0.5994
1991716644473195_2340917116219811,1,0,0,1,0.4404
1991716644473195_2340926679552188,1,0,0,1,0.7506
1991716644473195_2340929819551874,2,0,0,2,0.8619
1991716644473195_2340956179549238,4,1,0,5,2.5964
1991716644473195_2340982522879937,1,0,0,1,0.4404
1991716644473195_2340986496212873,20,5,0,25,12.1781
1991716644473195_2340993299545526,2,0,0,2,0.8808
1991716644473195_2340993552878834,0,0,1,1,-0.4019
1991716644473195_2340997626211760,2,0,0,2,0.9331
1991716644473195_2341209266190596,2,0,0,2,0.8619
1991716644473195_2341211489523707,10,3,0,13,4.8497
1991716644473195_2341213449523511,11,0,0,11,6.3617
1991716644473195_2341236996187823,1,0,0,1,0.4215
1991716644473195_2341259449518911,0,2,0,2,0
1991716644473195_2341320759512780,9,0,0,9,3.9419
1991716644473195_2341333392844850,2,0,0,2,1.0398
1991716644473195_2341341212844068,1,0,0,1,0.4404
1991716644473195_2341371386174384,3,0,0,3,1.3546
1991716644473195_2341375149507341,2,1,0,3,0.7397
1991716644473195_2341379942840195,1,0,0,1,0.4404
1991716644473195_2341410769503779,1,0,0,1,0.4404
1991716644473195_2341417366169786,1,0,0,1,0.4404
1991716644473195_2341419656169557,3,0,0,3,1.2834
1991716644473195_2341421286169394,9,0,0,9,4.7169
1991716644473195_2341424142835775,13,1,0,14,6.8371
1991716644473195_2341424846169038,1,0,0,1,0.4404
1991716644473195_2341440299500826,19,2,1,22,9.04
1991716644473195_2341442909500565,1,0,0,1,0.7088
1991716644473195_2341447226166800,1,0,0,1,0.4404
1991716644473195_2341451966166326,3,0,0,3,0.993
1991716644473195_2341456516165871,1,0,0,1,0.296
1991716644473195_2341461142832075,1,0,0,1,0.5994
1991716644473195_2341464522831737,22,3,0,25,11.5569
1991716644473195_2341469162831273,2,0,0,2,1.0775
1991716644473195_2341469199497936,1,0,0,1,0.4404
1991716644473195_2341469206164602,1,0,0,1,0.4215
1991716644473195_2341469802831209,1,0,0,1,0.4404
1991716644473195_2341472546164268,2,0,0,2,0.5176
1991716644473195_2341474326164090,1,0,0,1,0.4754
1991716644473195_2341486262829563,1,0,0,1,0.4754
1991716644473195_2341490436162479,2,0,0,2,0.8619
1991716644473195_2341508772827312,1,0,0,1,0.4404
1991716644473195_2341517206159802,1,0,0,1,0.4404
1991716644473195_2341522709492585,2,0,0,2,0.9331
1991716644473195_2341566466154876,2,0,0,2,0.8808
1991716644473195_2341575212820668,6,2,0,8,2.6758
1991716644473195_2341575676153955,1,0,0,1,0.4754
1991716644473195_2341583026153220,2,1,0,3,0.9142
1991716644473195_2341585086153014,7,3,0,10,4.1368
1991716644473195_2341590539485802,2,1,0,3,0.8997
1991716644473195_2341592556152267,1,0,0,1,0.6705
1991716644473195_2341597626151760,1,0,0,1,0.7579
1991716644473195_2341599776151545,1,1,0,2,0.6249
1991716644473195_2341619076149615,1,1,0,2,0.4404
1991716644473195_2341619942816195,2,2,0,4,0.8619
1991716644473195_2341620866149436,1,0,0,1,0.4754
1991716644473195_2341631092815080,6,0,0,6,3.1672
1991716644473195_2341663092811880,1,0,0,1,0.4404
1991716644473195_2341674509477405,1,0,0,1,0.4215
1991716644473195_2341676709477185,3,1,0,4,1.4291
1991716644473195_2341681026143420,2,0,0,2,0.8619
1991716644473195_2341682519476604,5,1,0,6,2.2531
1991716644473195_2341693279475528,8,1,0,9,3.8942
1991716644473195_2341706702807519,5,0,0,5,2.4086
1991716644473195_2341708842807305,1,0,0,1,0.4404
1991716644473195_2341715592806630,6,2,1,9,3.1091
1991716644473195_2341716486139874,16,9,0,25,6.9173
1991716644473195_2341720646139458,4,1,0,5,1.3795
1991716644473195_2341723472805842,16,9,0,25,8.4964
1991716644473195_2341728082805381,1,0,0,1,0.3182
1991716644473195_2341755086136014,1,1,0,2,0.5994
1991716644473195_2341780476133475,2,0,0,2,1.376
1991716644473195_2341803782797811,1,0,0,1,0.3291
1991716644473195_2341938482784341,3,0,0,3,1.4424
1991716644473195_2342014389443417,11,4,0,15,6.3784
1991716644473195_2342031342775055,4,0,0,4,2.1505
1991716644473195_2342043512773838,1,0,0,1,0.4404
1991716644473195_2342061856105337,1,1,0,2,0.4404
1991716644473195_2342087276102795,1,0,0,1,0.4215
1991716644473195_2342127622765427,12,0,0,12,7.1201
1991716644473195_2342140572764132,1,0,0,1,0.4215
1991716644473195_2342142626097260,0,2,0,2,0
1991716644473195_2342162619428594,3,21,1,25,1.0861
1991716644473195_2342163839428472,3,0,0,3,1.2834
1991716644473195_2342189762759213,1,0,0,1,0.4215
1991716644473195_2342211626090360,12,8,4,24,4.352
1991716644473195_2342212372756952,2,1,0,3,0.9331
1991716644473195_2342212432756946,1,0,0,1,0.0772
1991716644473195_2342213459423510,5,2,0,7,2.1831
1991716644473195_2342213836090139,2,0,0,2,1.0773
1991716644473195_2342228509422005,1,0,0,1,0.5994
1991716644473195_2342260789418777,5,3,1,9,2.0272
1991716644473195_2342296582748531,4,1,0,5,1.7049
1991716644473195_2342298036081719,4,0,0,4,1.7761
1991716644473195_2342308572747332,1,0,0,1,0.4404
1991716644473195_2342318292746360,3,2,1,6,0.5526
1991716644473195_2342321519412704,2,1,0,3,1.603
1991716644473195_2342337192744470,1,1,0,2,0.4215
1991716644473195_2342338862744303,1,0,1,2,0.3289
1991716644473195_2342349059409950,1,0,0,1,0.4404
1991716644473195_2342350876076435,5,0,0,5,3.1646
1991716644473195_2342356769409179,5,0,0,5,2.521
1991716644473195_2342368219408034,9,1,1,11,4.5673
1991716644473195_2342370542741135,1,0,0,1,0.5994
1991716644473195_2342393639405492,3,2,0,5,1.6462
1991716644473195_2342434296068093,3,0,0,3,1.2834
1991716644473195_2342482476063275,17,8,0,25,10.231
1991716644473195_2342661352712054,1,0,0,1,0.7003
1991716644473195_2342786912699498,2,0,0,2,0.8619
1991716644473195_2342825872695602,0,1,0,1,0
1991716644473195_2342847206026802,1,0,0,1,0.4927
1991716644473195_2342850506026472,1,1,0,2,0.5228
1991716644473195_2342876966023826,4,0,0,4,1.7049
1991716644473195_2342910489353807,1,0,0,1,0.4466
1991716644473195_2342931522685037,0,2,0,2,0
1991716644473195_2342940892684100,1,0,0,1,0.4404
1991716644473195_2342945026017020,7,0,0,7,4.4023
1991716644473195_2342951149349741,2,3,1,6,0.5607
1991716644473195_2342972536014269,1,0,0,1,0.4215
1991716644473195_2343012286010294,5,0,0,5,2.2957
1991716644473195_2343038626007660,8,12,1,21,3.2086
1991716644473195_2343228565988666,9,4,0,13,5.1526
1991716644473195_2343234805988042,3,0,0,3,1.5608
1991716644473195_2343248249320031,3,0,0,3,1.4988
1991716644473195_2343580795953443,23,1,1,25,11.6295
1991716644473195_2343608755950647,8,1,0,9,4.7303
1991716644473195_2343652669279589,5,1,0,6,2.4736
1991716644473195_2343677725943750,2,0,0,2,1.1176
1991716644473195_2343703969274459,1,0,0,1,0.9359
1991716644473195_2343717322606457,8,1,0,9,3.8268
1991716644473195_2343722899272566,7,1,0,8,3.4164
1991716644473195_2343735502604639,6,2,0,8,2.7631
1991716644473195_2343738142604375,3,1,0,4,1.4613
1991716644473195_2343742099270646,1,0,0,1,0.6249
1991716644473195_2343755032602686,5,0,0,5,2.6713
1991716644473195_2343781362600053,17,7,0,24,7.8827
1991716644473195_2343800572598132,0,9,0,9,0
1991716644473195_2343820699262786,12,13,0,25,4.8568
1991716644473195_2343825625928960,1,0,0,1,0.4215
1991716644473195_2343830759261780,2,0,0,2,0.8808
1991716644473195_2343834015928121,0,1,0,1,0
1991716644473195_2343847845926738,6,1,1,8,2.9556
1991716644473195_2343856662592523,1,1,0,2,0.4215
1991716644473195_2343886445922878,20,5,0,25,9.7477
1991716644473195_2343953939249462,1,0,0,1,0.4215
1991716644473195_2343989132579276,2,0,0,2,1.0653
1991716644473195_2344345085877014,8,0,0,8,3.7264
1991716644473195_2344352915876231,1,0,0,1,0.4404
1991716644473195_2344366759208180,5,0,0,5,2.1453
1991716644473195_2344395882538601,1,0,0,1,0.4404
1991716644473195_2344411722537017,3,0,0,3,1.4776
1991716644473195_2344442255867297,3,0,0,3,1.8118
1991716644473195_2344464995865023,5,0,0,5,2.1642
1991716644473195_2344465272531662,4,1,0,5,1.9392
1991716644473195_2344503162527873,2,0,0,2,1.0584
1991716644473195_2344560172522172,3,0,0,3,1.3212
1991716644473195_2344742295837293,2,0,0,2,0.8808
1991716644473195_2344745815836941,3,0,0,3,1.3184
1991716644473195_2345017632476426,15,3,0,18,7.4344
1991716644473195_2345144649130391,1,0,0,1,0.4215
1991716644473195_2345160919128764,2,1,0,3,0.9331
1991716644473195_2345210039123852,3,1,0,4,1.6475
1991716644473195_2345235139121342,8,2,0,10,4.1466
1991716644473195_2345253579119498,19,5,0,24,9.7032
1991716644473195_2345275679117288,2,0,0,2,1.7072
1991716644473195_2345291792449010,4,0,0,4,1.8882
1991716644473195_2345308269114029,6,0,0,6,3.2986
1991716644473195_2345321102446079,1,0,0,1,0.4404
1991716644473195_2345324095779113,2,0,0,2,1.0209
1991716644473195_2345330299111826,6,1,0,7,2.5857
1991716644473195_2345404265771096,2,0,0,2,0.8619
1991716644473195_2345655179079338,0,0,1,1,-0.296
1991716644473195_2345666199078236,2,0,0,2,0.8969
1991716644473195_2345839142394275,1,0,0,1,0.4215
1991716644473195_2345876719057184,5,0,0,5,2.602
1991716644473195_2345906692387520,10,2,0,12,4.9998
1991716644473195_2345909472387242,1,0,0,1,0.8225
1991716644473195_2345923719052484,6,2,0,8,2.7587
1991716644473195_2345955422382647,1,0,0,1,0.4215
1991716644473195_2345978405713682,4,0,0,4,1.795
1991716644473195_2345999785711544,10,2,0,12,4.2513
1991716644473195_2346001292378060,1,0,0,1,0.4404
1991716644473195_2346002822377907,1,0,0,1,0.6908
1991716644473195_2346015569043299,14,2,1,17,6.7299
1991716644473195_2346030259041830,2,1,0,3,1.0398
1991716644473195_2346048609039995,8,0,0,8,5.2896
1991716644473195_2346067462371443,4,0,0,4,2.111
1991716644473195_2346076985703824,20,5,0,25,11.6237
1991716644473195_2346197249025131,0,0,1,1,-0.296
1991716644473195_2346198779024978,1,0,0,1,0.4215
1991716644473195_2346234349021421,1,0,0,1,0.4215
1991716644473195_2346248472353342,14,8,0,22,5.7325
1991716644473195_2346268545684668,2,0,0,2,0.8423
1991716644473195_2346526955658827,5,2,0,7,2.6547
1991716644473195_2346559322322257,0,1,0,1,0
1991716644473195_2346637425647780,0,1,0,1,0
1991716644473195_2346662045645318,9,0,0,9,4.5068
1991716644473195_2346687352309454,1,0,0,1,0.4215
1991716644473195_2346760525635470,5,3,0,8,3.0491
1991716644473195_2346787458966110,1,0,0,1,0.4404
1991716644473195_2346804118964444,3,0,0,3,1.3821
1991716644473195_2346810772297112,3,0,0,3,1.4424
1991716644473195_2346810918963764,5,1,0,6,2.5555
1991716644473195_2346814105630112,8,0,0,8,4.1069
1991716644473195_2346855665625956,1,2,0,3,0.0772
1991716644473195_2346877495623773,3,0,0,3,1.3863
1991716644473195_2346880738956782,1,0,0,1,0.4404
1991716644473195_2346883052289884,2,0,0,2,1.1493
1991716644473195_2346898098955046,3,1,0,4,1.4098
1991716644473195_2346921788952677,2,2,0,4,1.1261
1991716644473195_2346936572284532,2,1,0,3,0.8619
1991716644473195_2346939202284269,1,0,0,1,0.4215
1991716644473195_2346957455615777,3,0,0,3,1.5513
1991716644473195_2347015902276599,3,0,0,3,2.0047
1991716644473195_2347095695601953,0,1,0,1,0
1991716644473195_2347110805600442,2,0,0,2,1.0209
1991716644473195_2347391915572331,1,2,0,3,0.5719
1991716644473195_2347392645572258,1,0,0,1,0.4754
1991716644473195_2347407885570734,1,0,0,1,0.6908
1991716644473195_2347416298903226,8,3,0,11,4.7793
1991716644473195_2347438548901001,12,1,0,13,5.788
1991716644473195_2347491022229087,10,10,1,21,3.6881
1991716644473195_2347495678895288,1,0,0,1,0.6249
1991716644473195_2347501232228066,1,4,0,5,0.327
1991716644473195_2347513598893496,1,0,0,1,0.4404
1991716644473195_2347518688892987,20,5,0,25,12.7372
1991716644473195_2347567962221393,1,0,0,1,0.4404
1991716644473195_2347626962215493,2,1,0,3,0.843
1991716644473195_2347750498869806,0,2,1,3,-0.296
1991716644473195_2347790982199091,7,1,0,8,4.578
1991716644473195_2347808152197374,7,0,0,7,3.778
1991716644473195_2347860108858845,1,0,0,1,0.3182
1991716644473195_2347874948857361,3,1,0,4,1.5898
1991716644473195_2347875588857297,1,0,0,1,0.4215
1991716644473195_2347880848856771,1,0,0,1,0.4404
1991716644473195_2347912438853612,1,0,0,1,0.4215
1991716644473195_2348269512151238,4,0,0,4,2.3601
1991716644473195_2348324802145709,1,1,0,2,0.4754
1991716644473195_2348419292136260,1,0,0,1,0.4404
1991716644473195_2348419518802904,2,0,0,2,1.0209
1991716644473195_2348483052129884,2,0,0,2,1.1438
1991716644473195_2348885108756345,8,2,0,10,4.8287
1991716644473195_2348937612084428,23,2,0,25,13.7906
1991716644473195_2348959098748946,1,1,0,2,0.8679
1991716644473195_2349000138744842,1,0,0,1,0.4404
1991716644473195_2349040008740855,1,0,0,1,0.4404
1991716644473195_2349047768740079,1,0,0,1,0.8126
1991716644473195_2349054035406119,1,2,0,3,0.4215
1991716644473195_2349061465405376,1,0,0,1,0.4215
1991716644473195_2349072775404245,1,0,0,1,0.4404
1991716644473195_2349076298737226,0,1,0,1,0
1991716644473195_2349087122069477,14,2,0,16,6.3595
1991716644473195_2349117192066470,1,0,0,1,0.6597
1991716644473195_2349120678732788,1,0,0,1,0.4215
1991716644473195_2349158895395633,1,0,0,1,0.4927
1991716644473195_2349204022057787,1,0,0,1,0.4215
1991716644473195_2349211122057077,15,3,0,18,8.5632
1991716644473195_2349212638723592,1,0,0,1,0.5244
1991716644473195_2349218378723018,3,0,0,3,1.8491
1991716644473195_2349219455389577,3,0,0,3,1.4613
1991716644473195_2349220268722829,3,0,0,3,1.2834
1991716644473195_2349220398722816,3,0,0,3,1.3023
1991716644473195_2349224385389084,8,7,0,15,4.1045
1991716644473195_2349251325386390,1,0,0,1,0.4215
1991716644473195_2349322278712628,2,3,0,5,0.843
1991716644473195_2349324998712356,1,0,0,1,0.4215
1991716644473195_2349338085377714,2,0,0,2,0.9142
1991716644473195_2349357402042449,2,1,0,3,1.3504
1991716644473195_2349395345371988,1,1,0,2,0.4215
1991716644473195_2349395498705306,4,3,0,7,1.7238
1991716644473195_2349610288683827,1,3,0,4,0.4404
1991716644473195_2349662202011969,1,0,0,1,0.8591
1991716644473195_2349664208678435,3,2,0,5,1.9125
1991716644473195_2349713628673493,6,0,0,6,3.4203
1991716644473195_2349745178670338,15,3,0,18,6.749
1991716644473195_2349781028666753,2,0,0,2,0.9158
1991716644473195_2349783641999825,3,2,0,5,1.7982
1991716644473195_2349802991997890,2,0,0,2,0.843
1991716644473195_2349812581996931,9,3,0,12,4.7187
1991716644473195_2349813721996817,2,0,0,2,0.8808
1991716644473195_2349818241996365,4,1,0,5,2.5233
1991716644473195_2349820801996109,3,0,0,3,2.1484
1991716644473195_2349835845327938,1,2,0,3,0.4215
1991716644473195_2349917138653142,1,0,0,1,0.3182
1991716644473195_2349927975318725,3,2,0,5,1.2834
1991716644473195_2349946018650254,5,0,0,5,2.2704
1991716644473195_2349952968649559,21,3,1,25,11.3568
1991716644473195_2349953121982877,7,1,0,8,3.2946
1991716644473195_2349959668648889,20,1,0,21,10.5196
1991716644473195_2349974481980741,5,0,0,5,3.2604
1991716644473195_2349980855313437,6,2,0,8,3.762
1991716644473195_2349985888646267,0,1,0,1,0
1991716644473195_2349987635312759,2,0,0,2,0.9331
1991716644473195_2350003978644458,3,1,0,4,1.6203
1991716644473195_2350004095311113,2,1,0,3,0.7586
1991716644473195_2350008315310691,1,0,0,1,0.4404
1991716644473195_2350025251975664,1,0,0,1,0.4404
1991716644473195_2350075058637350,2,0,0,2,0.8619
1991716644473195_2350079378636918,3,0,0,3,1.3212
1991716644473195_2350090145302508,2,0,0,2,1.1003
1991716644473195_2350092238635632,1,0,0,1,0.4404
1991716644473195_2350106108634245,13,1,0,14,6.9571
1991716644473195_2350107515300771,12,0,0,12,6.1835
1991716644473195_2350116268633229,17,7,0,24,9.5869
1991716644473195_2350135168631339,2,0,0,2,0.8016
1991716644473195_2350235388621317,17,1,0,18,10.1894
1991716644473195_2350324515279071,23,2,0,25,12.6349
1991716644473195_2350330105278512,3,1,0,4,1.7982
1991716644473195_2350377805273742,2,0,0,2,1.5112
1991716644473195_2350405721937617,4,0,0,4,1.6824
1991716644473195_2350422238602632,1,0,1,2,-0.0535
1991716644473195_2350462528598603,3,1,0,4,1.3357
1991716644473195_2350468458598010,0,1,0,1,0
1991716644473195_2350469521931237,6,1,0,7,3.8313
1991716644473195_2350471475264375,4,0,0,4,2.5822
1991716644473195_2350473821930807,3,0,0,3,1.4478
1991716644473195_2350504151927774,1,0,0,1,0.4404
1991716644473195_2350524025259120,4,0,0,4,2.143
1991716644473195_2350539265257596,14,5,1,20,6.3412
1991716644473195_2350541741924015,1,0,0,1,0.4215
1991716644473195_2350548401923349,7,0,0,7,3.5813
1991716644473195_2350599425251580,4,0,0,4,1.7238
1991716644473195_2350622675249255,1,0,0,1,0.4215
1991716644473195_2350646298580226,1,0,0,1,0.4404
1991716644473195_2350656795245843,1,0,0,1,0.4215
1991716644473195_2350673398577516,2,0,0,2,0.8808
1991716644473195_2350689448575911,2,0,0,2,0.8619
1991716644473195_2350696601908529,1,1,0,2,0.6908
1991716644473195_2350705488574307,11,5,0,16,6.8235
1991716644473195_2350747065236816,3,2,0,5,1.5897
1991716644473195_2350756115235911,0,1,0,1,0
1991716644473195_2350775375233985,18,5,0,23,9.47
1991716644473195_2350788101899379,0,2,0,2,0
1991716644473195_2350790361899153,1,0,0,1,0.4215
1991716644473195_2350799375231585,1,0,0,1,0.4404
1991716644473195_2350806781897511,9,4,0,13,5.1411
1991716644473195_2350808175230705,1,0,0,1,0.4404
1991716644473195_2350813145230208,2,0,0,2,0.8808
1991716644473195_2350816645229858,22,3,0,25,11.2416
1991716644473195_2350817825229740,3,2,0,5,1.4679
1991716644473195_2350826601895529,7,1,0,8,3.6231
1991716644473195_2350845548560301,4,1,0,5,2.0302
1991716644473195_2350855211892668,1,0,0,1,0.4215
1991716644473195_2351121025199420,22,3,0,25,11.2335
1991716644473195_2351128668531989,3,0,0,3,1.9134
1991716644473195_2351174278527428,1,1,0,2,0.4215
1991716644473195_2351182458526610,2,1,0,3,0.8619
1991716644473195_2351195548525301,1,1,0,2,0.4404
1991716644473195_2351246141853575,2,0,0,2,0.9158
1991716644473195_2351250701853119,2,0,0,2,0.843
1991716644473195_2351251595186363,18,6,1,25,10.0698
1991716644473195_2351276955183827,1,1,0,2,0.3612
1991716644473195_2351351428509713,1,1,0,2,0.4404
1991716644473195_2351351968509659,5,0,0,5,2.1642
1991716644473195_2351383208506535,24,1,0,25,10.6324
1991716644473195_2351389868505869,6,1,0,7,3.4336
1991716644473195_2351389911839198,1,1,0,2,0.4215
1991716644473195_2351390891839100,3,0,0,3,1.2754
1991716644473195_2351392648505591,2,0,0,2,1.305
1991716644473195_2351400751838114,2,0,0,2,0.8619
1991716644473195_2351402048504651,1,0,0,1,0.4215
1991716644473195_2351461828498673,10,5,3,18,4.5185
1991716644473195_2351466361831553,1,0,0,1,0.4754
1991716644473195_2351473698497486,6,2,0,8,2.6235
1991716644473195_2351496375161885,1,1,0,2,0.6249
1991716644473195_2351503691827820,3,1,1,5,0.8372
1991716644473195_2351521185159404,4,1,0,5,1.8937
1991716644473195_2351560881822101,2,0,0,2,1.0646
1991716644473195_2351561711822018,1,0,0,1,0.5994
1991716644473195_2351561718488684,2,3,0,5,1.2498
1991716644473195_2351562938488562,2,0,0,2,0.8619
1991716644473195_2351574905154032,12,0,0,12,7.8265
1991716644473195_2351575488487307,2,0,0,2,0.8619
1991716644473195_2351578905153632,2,2,0,4,1.4004
1991716644473195_2351593571818832,1,0,0,1,0.4215
1991716644473195_2351602855151237,2,0,0,2,0.843
1991716644473195_2351614468483409,2,1,0,3,0.8619
1991716644473195_2351837868461069,1,0,0,1,0.3612
1991716644473195_2351874188457437,1,0,0,1,0.2247
1991716644473195_2351894018455454,11,9,2,22,4.438
1991716644473195_2351926165118906,1,0,0,1,0.4939
1991716644473195_2351934245118098,14,3,0,17,7.6713
1991716644473195_2351960378448818,2,0,0,2,0.8619
1991716644473195_2351995518445304,16,2,0,18,8.3617
1991716644473195_2352018521776337,0,1,0,1,0
1991716644473195_2352044045107118,3,0,0,3,1.5527
1991716644473195_2352052351772954,8,1,0,9,4.5051
1991716644473195_2352063228438533,2,0,0,2,1.0584
1991716644473195_2352070448437811,3,0,0,3,1.3184
1991716644473195_2352106598434196,14,0,0,14,6.6526
1991716644473195_2352107508434105,1,1,0,2,0.2732
1991716644473195_2352109335100589,1,0,0,1,0.807
1991716644473195_2352116901766499,0,1,0,1,0
1991716644473195_2352159081762281,2,1,0,3,0.8619
1991716644473195_2352173248427531,2,1,0,3,0.7999
1991716644473195_2352173431760846,1,0,0,1,0.4215
1991716644473195_2352194415092081,21,4,0,25,9.6587
1991716644473195_2352202908424565,3,0,0,3,1.3373
1991716644473195_2352209061757283,6,3,0,9,3.3159
1991716644473195_2352211068423749,5,0,0,5,1.7821
1991716644473195_2352227201755469,1,0,0,1,0.4404
1991716644473195_2352228775088645,1,0,0,1,0.4404
1991716644473195_2352232108421645,1,0,0,1,0.3612
1991716644473195_2352266468418209,4,1,0,5,2.1399
1991716644473195_2352283848416471,1,1,0,2,0.4754
1991716644473195_2352298298415026,0,1,1,2,-0.296
1991716644473195_2352304968414359,2,0,0,2,1.3949
1991716644473195_2352309318413924,3,1,0,4,1.277
1991716644473195_2352346311743558,20,5,0,25,10.8967
1991716644473195_2352352511742938,4,4,0,8,2.6546
1991716644473195_2352379835073539,13,1,0,14,6.7001
1991716644473195_2352385321739657,3,0,0,3,1.6236
1991716644473195_2352393331738856,2,1,0,3,0.1544
1991716644473195_2352428318402024,24,1,0,25,13.7041
1991716644473195_2352683878376468,11,0,0,11,6.4261
1991716644473195_2352707941707395,1,0,0,1,0.4404
1991716644473195_2352715095040013,11,3,0,14,7.0587
1991716644473195_2352754018369454,1,0,0,1,0.4404
1991716644473195_2352762131701976,6,0,0,6,3.7988
1991716644473195_2352796581698531,6,2,0,8,3.5964
1991716644473195_2352801521698037,2,0,0,2,0.9648
1991716644473195_2352826755028847,19,6,0,25,11.2289
1991716644473195_2352859585025564,6,3,0,9,4.1079
1991716644473195_2352884258356430,1,0,0,1,0.4754
1991716644473195_2352888518356004,0,3,0,3,0
1991716644473195_2352932398351616,4,0,0,4,2.2052
1991716644473195_2352934461684743,1,1,0,2,0.8491
1991716644473195_2352953465016176,1,1,0,2,0.796
1991716644473195_2352991225012400,1,0,0,1,0.9563
1991716644473195_2353060071672182,19,4,0,23,9.417
1991716644473195_2353135784997944,1,0,0,1,0.7269
1991716644473195_2353147244996798,11,0,0,11,5.5199
1991716644473195_2353454558299400,10,1,0,11,5.6953
1991716644473195_2353479228296933,14,0,0,14,7.4226
1991716644473195_2353524198292436,2,0,0,2,1.2243
1991716644473195_2353599008284955,1,0,0,1,0.4404
1991716644473195_2353617618283094,3,0,0,3,1.3023
1991716644473195_2353627321615457,2,0,0,2,1.0992
1991716644473195_2353696978275158,2,1,0,3,1.53
1991716644473195_2353714701606719,0,2,0,2,0
1991716644473195_2353838438261012,6,3,0,9,3.8005
1991716644473195_2353995734911949,5,0,0,5,2.6464
1991716644473195_2354293948215461,16,1,1,18,8.6025
1991716644473195_2354374784874044,0,1,0,1,0
1991716644473195_2354381271540062,22,3,0,25,11.0956
1991716644473195_2354418621536327,2,0,0,2,0.8969
1991716644473195_2354444421533747,0,2,0,2,0
1991716644473195_2354521298192726,2,1,0,3,0.8619
1991716644473195_2354539521524237,1,0,0,1,0.765
1991716644473195_2354541868190669,1,0,0,1,0.4215
1991716644473195_2354594324852090,1,0,0,1,0.4754
1991716644473195_2354597424851780,2,0,0,2,0.7827
1991716644473195_2354603211517868,4,0,0,4,1.8617
1991716644473195_2354618811516308,6,0,0,6,3.5964
1991716644473195_2354639228180933,1,1,0,2,0.5994
1991716644473195_2354655508179305,24,1,0,25,11.6138
1991716644473195_2354738561504333,2,0,0,2,1.0653
1991716644473195_2354739654837557,2,1,0,3,0.9681
1991716644473195_2355044701473719,3,1,0,4,1.706
1991716644473195_2355050261473163,1,1,0,2,0.4404
1991716644473195_2355113488133507,1,0,0,1,0.6249
1991716644473195_2355116201466569,5,0,1,6,1.8977
1991716644473195_2355120761466113,1,0,0,1,0.4215
1991716644473195_2355182361459953,18,2,0,20,9.2418
1991716644473195_2355185084793014,2,0,0,2,1.1407
1991716644473195_2355189458125910,1,0,0,1,0.4404
1991716644473195_2355194808125375,1,0,0,1,0.4404
1991716644473195_2355241641454025,14,1,0,15,7.4033
1991716644473195_2355255934785929,18,7,0,25,10.1629
1991716644473195_2355265998118256,10,0,0,10,5.297
1991716644473195_2355307618114094,2,0,0,2,1.4764
1991716644473195_2355311501447039,1,0,0,1,0.5994
1991716644473195_2355326881445501,1,1,0,2,0.4215
1991716644473195_2355339324777590,1,0,0,1,0.7177
1991716644473195_2355340638110792,1,0,0,1,0.4927
1991716644473195_2355342084777314,17,0,0,17,8.1865
1991716644473195_2355343164777206,3,0,0,3,1.7043
1991716644473195_2355347178110138,0,1,0,1,0
1991716644473195_2355350694776453,1,0,0,1,0.4215
1991716644473195_2355351924776330,4,3,0,7,2.1418
1991716644473195_2355405628104293,1,1,0,2,0.4404
1991716644473195_2355419364769586,1,0,0,1,0.4404
1991716644473195_2355421044769418,1,0,0,1,0.4215
1991716644473195_2355427971435392,1,0,0,1,0.0772
1991716644473195_2355428254768697,7,3,0,10,4.1146
1991716644473195_2355441161434073,2,0,0,2,0.8619
1991716644473195_2355470008097855,1,0,0,1,0.4404
1991716644473195_2355476551430534,17,8,0,25,6.6813
1991716644473195_2355504024761120,5,0,0,5,2.538
1991716644473195_2355514874760035,5,0,0,5,2.3676
1991716644473195_2355523641425825,10,0,0,10,6.0838
1991716644473195_2355527734758749,1,2,0,3,0.4404
1991716644473195_2355532634758259,0,1,0,1,0
1991716644473195_2355542214757301,6,0,0,6,2.8927
1991716644473195_2355817341396455,1,0,0,1,0.4215
1991716644473195_2355892588055597,1,1,0,2,0.4404
1991716644473195_2355960778048778,13,2,0,15,6.0411
1991716644473195_2355960811382108,9,4,0,13,4.4037
1991716644473195_2355972811380908,19,6,0,25,11.5519
1991716644473195_2356006884710834,1,0,0,1,0.6908
1991716644473195_2356015274709995,2,0,0,2,1.2895
1991716644473195_2356019074709615,2,2,0,4,0.9343
1991716644473195_2356024638042392,7,0,0,7,3.1765
1991716644473195_2356040401374149,2,0,0,2,1.4774
1991716644473195_2356042761373913,3,0,0,3,1.5324
1991716644473195_2356048294706693,7,1,0,8,3.3346
1991716644473195_2356050934706429,1,2,0,3,0.4404
1991716644473195_2356056631372526,18,2,0,20,9.2735
1991716644473195_2356066061371583,0,1,0,1,0
1991716644473195_2356104374701085,21,4,0,25,10.3132
1991716644473195_2356168754694647,2,0,0,2,0.8619
1991716644473195_2356186868026169,2,0,0,2,1.2895
1991716644473195_2356199348024921,4,1,0,5,1.3795
1991716644473195_2356200828024773,1,0,0,1,0.4215
1991716644473195_2356201358024720,13,9,0,22,6.3318
1991716644473195_2356251538019702,3,2,0,5,2.1664
1991716644473195_2356253624686160,1,1,0,2,0.8491
1991716644473195_2356269571351232,2,0,1,3,0.719
1991716644473195_2356280051350184,0,1,0,1,0
1991716644473195_2356297051348484,3,0,0,3,2.0801
1991716644473195_2356302298014626,1,0,0,1,0.4754
1991716644473195_2356302954681227,2,2,0,4,0.8808
1991716644473195_2356310884680434,1,1,0,2,0.4215
1991716644473195_2356355491342640,24,1,0,25,14.9784
1991716644473195_2356364508008405,5,1,0,6,2.1642
1991716644473195_2356419621336227,1,0,0,1,0.4215
1991716644473195_2356712417973614,6,19,0,25,2.2696
1991716644473195_2356742497970606,12,3,0,15,7.0338
1991716644473195_2356773914634131,2,0,0,2,0.8619
1991716644473195_2356776474633875,5,1,0,6,2.5509
1991716644473195_2356847387960117,8,0,0,8,3.6917
1991716644473195_2356887674622755,5,17,3,25,1.3502
1991716644473195_2356910821287107,11,0,0,11,7.0164
1991716644473195_2356975251280664,7,4,0,11,3.0422
1991716644473195_2356995497945306,4,8,0,12,2.1032
1991716644473195_2357005941277595,1,0,0,1,0.5244
1991716644473195_2357007634610759,9,0,0,9,4.6259
1991716644473195_2357018514609671,7,17,1,25,2.842
1991716644473195_2357019887942867,1,1,0,2,0.8491
1991716644473195_2357021314609391,5,2,0,7,2.3421
1991716644473195_2357038934607629,10,1,0,11,4.8825
1991716644473195_2357058974605625,1,1,0,2,0.4927
1991716644473195_2357086701269519,2,1,0,3,1.1003
1991716644473195_2357092517935604,19,2,0,21,11.4398
1991716644473195_2357111281267061,1,0,0,1,0.4404
1991716644473195_2357130947931761,1,0,0,1,0.4404
1991716644473195_2357180364593486,11,2,0,13,5.0808
1991716644473195_2357253364586186,2,3,0,5,0.843
1991716644473195_2357274211250768,1,0,0,1,0.8491
1991716644473195_2357499297894926,5,0,0,5,2.8583
1991716644473195_2357514984560024,1,0,0,1,0.5994
1991716644473195_2357607187884137,10,15,0,25,4.6023
1991716644473195_2357617327883123,3,1,0,4,1.5017
1991716644473195_2357658007879055,5,1,0,6,2.2205
1991716644473195_2357664371211752,3,0,0,3,1.5057
1991716644473195_2357665661211623,2,3,0,5,0.9158
1991716644473195_2357678641210325,5,9,0,14,2.6532
1991716644473195_2357744821203707,0,1,0,1,0
1991716644473195_2357768524534670,11,14,0,25,5.2421
1991716644473195_2357785877866268,5,10,0,15,2.7469
1991716644473195_2357824677862388,1,0,0,1,0.9485
1991716644473195_2357885557856300,7,0,0,7,3.7904
1991716644473195_2357885591189630,2,0,0,2,1.0209
1991716644473195_2357909424520580,5,4,0,9,2.6408
1991716644473195_2357929157851940,3,1,0,4,2.1158
1991716644473195_2357932857851570,1,1,0,2,0.4404
1991716644473195_2357947151183474,1,0,0,1,0.9485
1991716644473195_2357954467849409,1,0,0,1,0.4215
1991716644473195_2357974477847408,9,3,0,12,5.2384
1991716644473195_2357975817847274,23,2,0,25,13.7255
1991716644473195_2357999281178261,6,13,0,19,3.9385
1991716644473195_2358134861164703,0,1,0,1,0
1991716644473195_2358135284497994,1,2,0,3,0.4215
1991716644473195_2358326697812186,10,15,0,25,4.6075
1991716644473195_2358386351139554,16,1,0,17,10.2655
1991716644473195_2358465364464986,1,0,0,1,0.4404
1991716644473195_2358467874464735,1,0,0,1,0.9359
1991716644473195_2358476237797232,3,5,0,8,1.8863
1991716644473195_2358495904461932,2,0,0,2,0.8016
1991716644473195_2358539624457560,2,1,0,3,1.1812
1991716644473195_2358542531123936,2,0,0,2,1.1998
1991716644473195_2358565137788342,2,1,0,3,1.3763
1991716644473195_2358565234454999,5,3,0,8,1.8388
1991716644473195_2358587134452809,4,2,0,6,2.3743
1991716644473195_2358588987785957,1,0,0,1,0.4215
1991716644473195_2358603677784488,3,1,0,4,1.7796
1991716644473195_2358614907783365,5,10,0,15,3.8756
1991716644473195_2358648467780009,9,13,0,22,5.0898
1991716644473195_2358657451112444,2,1,0,3,1.3644
1991716644473195_2358702794441243,7,2,0,9,4.1086
1991716644473195_2358706597774196,2,0,0,2,1.0653
1991716644473195_2358732857771570,3,5,0,8,2.0085
1991716644473195_2358845564426966,2,0,0,2,0.9331
1991716644473195_2358882181089971,7,10,0,17,3.7319
1991716644473195_2358928197752036,3,1,0,4,1.2834
1991716644473195_2358933261084863,1,0,0,1,0.5994
1991716644473195_2358952314416291,7,1,0,8,4.3755
1991716644473195_2358975551080634,3,0,0,3,1.7052
1991716644473195_2359212117723644,1,0,0,1,0.4754
1991716644473195_2359314737713382,8,1,0,9,4.8901
1991716644473195_2359347027710153,1,0,0,1,0.4404
1991716644473195_2359360704375452,9,16,0,25,3.0084
1991716644473195_2359398701038319,2,0,0,2,1.1262
1991716644473195_2359409837703872,11,11,3,25,3.3962
1991716644473195_2359418481036341,1,0,0,1,0.4404
1991716644473195_2359456514365871,2,0,0,2,1.2837
1991716644473195_2359476601030529,0,1,0,1,0
1991716644473195_2359530527691803,1,0,0,1,0.6588
1991716644473195_2359603134351209,5,3,0,8,2.6947
1991716644473195_2359663861011803,0,1,0,1,0
1991716644473195_2359709081007281,1,0,0,1,0.4215
1991716644473195_2360083630969826,5,1,0,6,2.9544
1991716644473195_2360106657634190,6,1,0,7,3.2659
1991716644473195_2360114020966787,1,1,0,2,0.4215
1991716644473195_2360146837630172,3,7,0,10,1.6756
1991716644473195_2360171374294385,1,0,0,1,0.4754
1991716644473195_2360219417622914,8,17,0,25,3.3436
1991716644473195_2360219747622881,1,0,0,1,0.8176
1991716644473195_2360226210955568,3,0,0,3,1.8794
1991716644473195_2360248830953306,8,4,0,12,3.3486
1991716644473195_2360298394281683,1,0,0,1,0.5994
1991716644473195_2360300524281470,2,0,0,2,1.0398
1991716644473195_2360303650947824,2,0,0,2,1.8844
1991716644473195_2360307317614124,20,5,0,25,12.2904
1991716644473195_2360310334280489,5,6,0,11,2.9866
1991716644473195_2360310887613767,6,3,0,9,3.8564
1991716644473195_2360320777612778,4,2,0,6,3.2114
1991716644473195_2360320824279440,8,1,0,9,4.8168
1991716644473195_2360351297609726,0,2,0,2,0
1991716644473195_2360366647608191,5,0,0,5,3.2498
1991716644473195_2360372790940910,0,1,0,1,0
1991716644473195_2360374227607433,0,1,0,1,0
1991716644473195_2360391327605723,4,0,0,4,1.4985
1991716644473195_2360463927598463,3,10,1,14,0.5616
1991716644473195_2360465550931634,6,19,0,25,3.0407
1991716644473195_2360465630931626,2,0,0,2,0.9459
1991716644473195_2360470640931125,7,9,0,16,3.6292
1991716644473195_2360517974259725,11,0,0,11,6.64
1991716644473195_2360519690926220,1,0,0,1,0.4754
1991716644473195_2360545484256974,0,1,0,1,0
1991716644473195_2360549720923217,0,1,0,1,0
1991716644473195_2360574070920782,2,0,0,2,0.9142
1991716644473195_2360574447587411,3,0,0,3,1.6458
1991716644473195_2360872720890917,2,5,0,7,0.6979
1991716644473195_2360990500879139,2,0,0,2,1.0992
1991716644473195_2361002014211321,0,1,0,1,0
1991716644473195_2361016974209825,3,2,0,5,1.3735
1991716644473195_2361017434209779,1,1,0,2,0.4754
1991716644473195_2361024444209078,0,1,0,1,0
1991716644473195_2361035797541276,4,6,0,10,2.4014
1991716644473195_2361047887540067,1,0,0,1,0.4215
1991716644473195_2361048010873388,4,1,0,5,2.3956
1991716644473195_2361050334206489,8,2,0,10,4.6264
1991716644473195_2361058300872359,11,0,0,11,5.4249
1991716644473195_2361101164201406,1,1,0,2,0.5267
1991716644473195_2361115560866633,5,3,0,8,3.3166
1991716644473195_2361122630865926,2,0,0,2,0.9934
1991716644473195_2361129137531942,3,0,0,3,1.5207
1991716644473195_2361142900863899,6,1,0,7,4.1119
1991716644473195_2361143517530504,1,0,0,1,0.4404
1991716644473195_2361146807530175,0,1,0,1,0
1991716644473195_2361146960863493,6,7,0,13,3.3011
1991716644473195_2361154127529443,5,0,0,5,2.9243
1991716644473195_2361171137527742,1,0,0,1,0.4927
1991716644473195_2361173844194138,1,0,0,1,0.5244
1991716644473195_2361199920858197,20,4,1,25,11.5028
1991716644473195_2361215214190001,0,1,0,1,0
1991716644473195_2361258047519051,3,0,0,3,1.9638
1991716644473195_2361262700851919,9,0,0,9,5.6508
1991716644473195_2361292630848926,1,0,0,1,0.5994
1991716644473195_2361292954182227,3,5,0,8,1.6458
1991716644473195_2361293330848856,1,0,0,1,0.5994
1991716644473195_2361301554181367,2,3,0,5,1.1751
1991716644473195_2361317034179819,4,0,0,4,2.0607
1991716644473195_2361329057511950,1,0,0,1,0.4215
1991716644473195_2361346967510159,1,2,0,3,0.5244
1991716644473195_2361591397485716,2,7,1,10,1.2798
1991716644473195_2361600284151494,4,1,0,5,1.989
1991716644473195_2361603907484465,7,5,1,13,3.4656
1991716644473195_2361701867474669,2,0,0,2,1.2894
1991716644473195_2361709647473891,6,0,0,6,3.5706
1991716644473195_2361715190806670,5,6,0,11,3.2159
1991716644473195_2361724787472377,2,0,0,2,1.3496
1991716644473195_2361726040805585,1,0,0,1,0.4404
1991716644473195_2361727140805475,2,0,0,2,0.8808
1991716644473195_2361727794138743,1,0,0,1,0.6588
1991716644473195_2361751160803073,3,0,0,3,1.9487
1991716644473195_2361754554136067,1,0,0,1,0.4404
1991716644473195_2361781447466711,3,0,0,3,1.7034
1991716644473195_2361787887466067,2,0,0,2,0.8619
1991716644473195_2361831164128406,2,0,0,2,0.8619
1991716644473195_2361856550792534,3,1,0,4,1.8482
1991716644473195_2361866640791525,1,0,0,1,0.8442
1991716644473195_2361883267456529,1,1,0,2,0.5267
1991716644473195_2361931350785054,5,3,0,8,2.4875
1991716644473195_2361951014116421,1,0,0,1,0.4404
1991716644473195_2361987854112737,1,1,0,2,0.4404
1991716644473195_2362005464110976,1,0,0,1,0.4404
1991716644473195_2362038830774306,12,0,0,12,6.0627
1991716644473195_2362087710769418,2,0,0,2,1.5582
1991716644473195_2362133680764821,1,0,0,1,0.4404
1991716644473195_2362153317429524,6,3,1,10,3.4831
1991716644473195_2362331020745087,1,0,0,1,0.4404
1991716644473195_2362450897399766,5,20,0,25,1.9722
1991716644473195_2362487010729488,14,11,0,25,7.3083
1991716644473195_2362492850728904,4,1,0,5,2.2978
1991716644473195_2362519424059580,2,0,0,2,0.8619
1991716644473195_2362528587391997,2,2,0,4,1.0748
1991716644473195_2362580670720122,6,13,0,19,3.637
1991716644473195_2362631527381703,3,11,0,14,2.0213
1991716644473195_2362657807379075,7,1,0,8,4.3248
1991716644473195_2362663970711792,4,3,0,7,2.2555
1991716644473195_2362685154043007,1,1,0,2,0.5244
1991716644473195_2362694667375389,1,1,0,2,0.4404
1991716644473195_2362701047374751,2,2,0,4,1.6054
1991716644473195_2362714020706787,5,5,0,10,2.6967
1991716644473195_2362738820704307,3,6,0,9,1.2466
1991716644473195_2362752717369584,3,1,0,4,1.5511
1991716644473195_2362755350702654,1,0,0,1,0.5719
1991716644473195_2362758240702365,1,0,0,1,0.8442
1991716644473195_2362767057368150,1,4,2,7,0.058
1991716644473195_2362845187360337,2,0,0,2,0.8808
1991716644473195_2362858190692370,0,3,0,3,0
1991716644473195_2362862690691920,23,2,0,25,11.3564
1991716644473195_2362867264024796,2,0,0,2,0.8619
1991716644473195_2362881030690086,15,3,0,18,7.0204
1991716644473195_2362906587354197,1,0,0,1,0.4215
1991716644473195_2363318883979634,2,0,0,2,1.4786
1991716644473195_2363405400637649,1,2,0,3,0.3182
1991716644473195_2363412903970232,3,0,0,3,1.4868
1991716644473195_2363414507303405,7,5,0,12,3.9982
1991716644473195_2363414853970037,2,2,0,4,0.9214
1991716644473195_2363435870634602,1,0,0,1,0.4404
1991716644473195_2363439780634211,0,1,0,1,0
1991716644473195_2363445143967008,0,2,0,2,0
1991716644473195_2363451367299719,3,10,0,13,1.3212
1991716644473195_2363475093964013,3,1,0,4,1.5374
1991716644473195_2363484740629715,2,0,0,2,0.9861
1991716644473195_2363490830629106,3,3,0,6,1.8051
1991716644473195_2363532807291575,1,0,0,1,0.5719
1991716644473195_2363555177289338,3,1,0,4,1.824
1991716644473195_2363569260621263,1,0,0,1,0.4404
1991716644473195_2363631523948370,2,1,0,3,0.9934
1991716644473195_2363631983948324,3,0,0,3,1.4868
1991716644473195_2363634137281442,1,0,0,1,0.4215
1991716644473195_2363639777280878,6,3,0,9,3.4185
1991716644473195_2363650617279794,8,3,0,11,4.4485
1991716644473195_2363661333945389,7,8,0,15,4.1479
1991716644473195_2363671187277737,3,0,0,3,1.9555
1991716644473195_2363681353943387,23,2,0,25,11.6378
1991716644473195_2363708873940635,3,1,0,4,1.8054
1991716644473195_2363711327273723,2,0,0,2,0.843
1991716644473195_2363714683940054,6,6,0,12,3.2019
1991716644473195_2363740197270836,2,0,0,2,0.9681
1991716644473195_2363753583936164,0,1,0,1,0
1991716644473195_2363787853932737,1,2,0,3,0.9844
1991716644473195_2363891297255726,3,3,0,6,1.8644
1991716644473195_2364059073905615,4,6,0,10,2.3883
1991716644473195_2364089483902574,2,0,0,2,0.9508
1991716644473195_2364107593900763,3,0,0,3,1.7509
1991716644473195_2364109247233931,3,0,0,3,1.7052
1991716644473195_2364110823900440,2,1,0,3,1.0748
1991716644473195_2364135373897985,3,0,0,3,1.6467
1991716644473195_2364142513897271,17,8,0,25,9.5495
1991716644473195_2364150530563136,2,0,0,2,0.843
1991716644473195_2364150667229789,2,0,0,2,1.5151
1991716644473195_2364180220560167,5,0,0,5,2.1831
1991716644473195_2364212257223630,1,0,0,1,0.9313
1991716644473195_2364248060553383,1,0,0,1,0.5994
1991716644473195_2364257893885733,2,0,0,2,1.6739
1991716644473195_2364264903885032,2,0,0,2,1.909
1991716644473195_2364267217218134,2,0,0,2,1.2245
1991716644473195_2364268067218049,0,1,0,1,0
1991716644473195_2364305927214263,1,0,0,1,0.4215
1991716644473195_2364310427213813,0,1,0,1,0
1991716644473195_2364325307212325,1,0,0,1,0.4215
1991716644473195_2364355383875984,3,1,0,4,1.6844
1991716644473195_2364381177206738,1,0,0,1,0.4404
1991716644473195_2364384943873028,1,0,0,1,0.4215
1991716644473195_2364457120532477,4,0,0,4,2.4174
1991716644473195_2364487033862819,2,0,0,2,0.7224
1991716644473195_2364490230529166,1,0,0,1,0.5244
1991716644473195_2364516000526589,2,0,0,2,1.5151
1991716644473195_2364523557192500,2,0,0,2,1.4872
1991716644473195_2364532340524955,1,0,0,1,0.4215
1991716644473195_2364549437189912,2,0,0,2,1.5151
1991716644473195_2364562167188639,1,0,0,1,0.9313
1991716644473195_2364576553853867,1,0,0,1,0.5994
1991716644473195_2364647447180111,21,4,0,25,11.4745
1991716644473195_2364671220511067,3,0,0,3,1.3293
1991716644473195_2364742007170655,6,0,0,6,3.6905
1991716644473195_2364800980498091,1,0,0,1,0.5994
1991716644473195_2365083260469863,2,0,0,2,1.3647
1991716644473195_2365086400469549,1,3,0,4,0.765
1991716644473195_2365089040469285,2,2,1,5,0.1953
1991716644473195_2365109690467220,1,0,0,1,0.9432
1991716644473195_2365123337132522,2,0,0,2,1.1001
1991716644473195_2365128417132014,11,1,0,12,6.54
1991716644473195_2365180197126836,2,1,0,3,1.3299
1991716644473195_2365396417105214,1,0,0,1,0.7264
1991716644473195_2365435693767953,8,1,0,9,4.8045
1991716644473195_2365581003753422,1,0,0,1,0.4404
1991716644473195_2365929447051911,4,0,0,4,2.0134
1991716644473195_2365941143717408,2,0,0,2,1.5032
1991716644473195_2365942787050577,4,0,0,4,2.0663
1991716644473195_2365944847050371,2,4,0,6,1.4067
1991716644473195_2365945110383678,2,1,0,3,1.3029
1991716644473195_2365953663716156,1,0,0,1,0.9432
1991716644473195_2365959940382195,0,1,0,1,0
1991716644473195_2365978377047018,0,4,0,4,0
1991716644473195_2366018137043042,1,0,0,1,0.4926
1991716644473195_2366072023704320,6,0,0,6,4.0851
1991716644473195_2366176580360531,3,0,0,3,1.2054
1991716644473195_2366248463686676,2,0,0,2,0.9331
1991716644473195_2366329297011926,1,0,0,1,0.9055
1991716644473195_2366396803671842,4,3,0,7,1.7259
1991716644473195_2366869033624619,15,2,0,17,7.5187
1991716644473195_2366886360289553,4,0,0,4,1.8267
1991716644473195_2367018253609697,3,7,0,10,1.3558
1991716644473195_2367540996890756,19,6,0,25,11.0428
1991716644473195_2367602366884619,2,3,0,5,0.8726
1991716644473195_2367609090217280,3,2,0,5,1.4688
1991716644473195_2367711090207080,1,0,0,1,0.6757
1991716644473195_2367713956873460,1,0,0,1,0.4927
1991716644473195_2367726363538886,1,0,0,1,0.4215
1991716644473195_2367730193538503,1,0,0,1,0.9432
1991716644473195_2367735136871342,9,3,0,12,5.04
1991716644473195_2367853780192811,2,1,0,3,0.9671
1991716644473195_2367958666848989,3,3,0,6,1.9366
1991716644473195_2368001670178022,2,2,0,4,0.9934
1991716644473195_2368043636840492,1,0,0,1,0.4404
1991716644473195_2368475596797296,2,1,0,3,0.9331
1991716644473195_2368481216796734,2,2,0,4,1.5151
1991716644473195_2368489280129261,2,0,0,2,0.9648
1991716644473195_2368490713462451,4,0,0,4,2.2305
1991716644473195_2368535746791281,1,0,0,1,0.4404
1991716644473195_2368550110123178,5,0,0,5,3.0225
1991716644473195_2368660313445491,1,0,0,1,0.4927
1991716644473195_2368686133442909,1,0,0,1,0.4215
1991716644473195_2368693176775538,2,2,0,4,1.3475
1991716644473195_2368693523442170,6,1,0,7,2.9034
1991716644473195_2368715763439946,2,1,0,3,1.1566
1991716644473195_2368835980094591,5,2,0,7,2.6793
1991716644473195_2368851723426350,15,1,0,16,9.7587
1991716644473195_2368870716757784,1,1,0,2,0.4215
1991716644473195_2368879156756940,6,0,0,6,3.1558
1991716644473195_2368918850086304,2,1,0,3,1.0123
1991716644473195_2369196503391872,2,3,0,5,0.5176
1991716644473195_2369256273385895,2,0,0,2,1.0123
1991716644473195_2369289330049256,3,3,0,6,1.5927
1991716644473195_2369702573341265,0,1,0,1,0
1991716644473195_2370621839916005,3,0,0,3,1.2019
1991716644473195_2371212973190225,3,4,0,7,1.6027
1991716644473195_2371255013186021,13,9,2,24,5.9122
1991716644473195_2371551666489689,4,1,1,6,1.4605
1991716644473195_2371840936460762,2,1,0,3,0.8808
1991716644473195_2371941619784027,4,21,0,25,2.1235
1991716644473195_2372052336439622,3,22,0,25,1.8987
1991716644473195_2372334933078029,1,1,0,2,0.5994
1991716644473195_2372434843068038,18,7,0,25,10.6085
1991716644473195_2372930229685166,10,3,0,13,4.4178
1991716644473195_2373119392999583,11,14,0,25,6.153
1991716644473195_2373679606276895,1,0,0,1,0.4215
1991716644473195_2373679869610202,1,0,0,1,0.4215
1991716644473195_2373914962920026,17,4,0,21,10.7414
1991716644473195_2373972322914290,13,3,0,16,7.1142
1991716644473195_2374011119577077,15,10,0,25,8.3015
1991716644473195_2374050599573129,20,5,0,25,10.4561
1991716644473195_2374526972858825,2,0,0,2,1.1188
1991716644473195_2374587492852773,1,1,0,2,0.6966
1991716644473195_2375701452741377,3,1,0,4,1.5152
1991716644473195_2376077529370436,9,0,0,9,4.4539
1991716644473195_2376189269359262,4,1,0,5,1.745
1991716644473195_2376505442660978,2,0,0,2,0.8808
1991716644473195_2376874209290768,3,1,0,4,1.0579
1991716644473195_2376885402622982,19,5,1,25,8.828
1991716644473195_2377032292608293,10,0,0,10,5.043
1991716644473195_2377584159219773,0,2,1,3,-0.6808
1991716644473195_2377906582520864,5,0,0,5,2.6393
1991716644473195_2378064435838412,5,2,0,7,2.2877
1991716644473195_2378883019089887,8,7,3,18,1.7132
1991716644473195_2378975705747285,1,0,0,1,0.5244
1991716644473195_2379090692402453,16,4,0,20,8.0814
1991716644473195_2379100232401499,22,3,0,25,12.7728
1991716644473195_2379119102399612,1,0,0,1,0.5719
1991716644473195_2379122555732600,7,1,0,8,3.1313
1991716644473195_2379710225673833,24,1,0,25,11.2859
1991716644473195_2379754242336098,3,7,0,10,1.5369
1991716644473195_2379760449002144,7,0,0,7,3.437
1991716644473195_2379768732334649,6,18,1,25,4.0982
1991716644473195_2379875062324016,1,0,0,1,0.765
1991716644473195_2379881992323323,10,9,0,19,5.1765
1991716644473195_2379891275655728,2,0,0,2,1.3892
1991716644473195_2379922908985898,4,3,0,7,1.4906
1991716644473195_2379935008984688,1,0,0,1,0.4215
1991716644473195_2379937305651125,24,1,0,25,12.4693
1991716644473195_2379940038984185,2,0,0,2,0.4987
1991716644473195_2379954702316052,7,17,1,25,2.9571
1991716644473195_2379959178982271,2,4,1,7,0.5302
1991716644473195_2379976222313900,1,0,0,1,0.7408
1991716644473195_2379978398980349,1,0,0,1,0.4404
1991716644473195_2380022098975979,2,1,0,3,1.0325
1991716644473195_2380051505639705,3,0,0,3,2.1578
1991716644473195_2380076292303893,2,1,0,3,1.0208
1991716644473195_2380099638968225,21,4,0,25,10.7222
1991716644473195_2380123238965865,5,0,0,5,2.6936
1991716644473195_2380139068964282,10,2,0,12,5.4261
1991716644473195_2380152345629621,6,0,0,6,2.9874
1991716644473195_2380180748960114,1,0,0,1,0.6908
1991716644473195_2380181105626745,2,0,0,2,0.7364
1991716644473195_2380257922285730,1,0,0,1,0.4404
1991716644473195_2380368002274722,2,0,0,2,1.1735
1991716644473195_2380373655607490,1,0,0,1,0.4754
1991716644473195_2380531002258422,2,0,0,2,1.4216
1991716644473195_2380746448903544,1,0,0,1,0.4404
1991716644473195_2380752782236244,5,0,0,5,2.4358
1991716644473195_2380784702233052,4,4,0,8,1.847
1991716644473195_2380792605565595,10,1,0,11,5.0625
1991716644473195_2380820628896126,7,0,0,7,3.2456
1991716644473195_2380832655561590,1,0,0,1,0.4215
1991716644473195_2380841418894047,4,2,0,6,2.0334
1991716644473195_2380845065560349,2,0,0,2,0.9158
1991716644473195_2380874765557379,2,0,0,2,1.1023
1991716644473195_2380895598888629,5,0,0,5,3.007
1991716644473195_2380931018885087,0,1,0,1,0
1991716644473195_2380961712215351,2,0,0,2,1.1023
1991716644473195_2381001195544736,5,0,0,5,2.8784
1991716644473195_2381020408876148,4,0,0,4,2.086
1991716644473195_2381024928875696,2,0,0,2,0.8619
1991716644473195_2381027632208759,12,3,0,15,5.4892
1991716644473195_2381037932207729,2,0,0,2,1.3057
1991716644473195_2381045145540341,3,1,0,4,1.5777
1991716644473195_2381049615539894,4,0,0,4,2.1685
1991716644473195_2381089242202598,1,0,0,1,0.6808
1991716644473195_2381130262198496,1,0,0,1,0.4404
1991716644473195_2381132085531647,5,0,0,5,2.1642
1991716644473195_2381160748862114,3,0,0,3,1.8862
1991716644473195_2381161692195353,8,1,0,9,4.6474
1991716644473195_2381210915523764,3,0,0,3,1.6456
1991716644473195_2381231022188420,8,0,0,8,5.317
1991716644473195_2381241942187328,1,0,0,1,0.6808
1991716644473195_2381243105520545,2,0,0,2,1.1562
1991716644473195_2381329745511881,0,1,0,1,0
1991716644473195_2381337352177787,3,1,0,4,1.6948
1991716644473195_2381492708828918,1,0,0,1,0.4404
1991716644473195_2381536195491236,3,1,0,4,1.8069
1991716644473195_2381556235489232,3,0,0,3,1.5616
1991716644473195_2381614688816720,10,0,0,10,4.749
1991716644473195_2381723192139203,2,0,0,2,1.4919
1991716644473195_2381736238804565,5,1,0,6,2.512
1991716644473195_2381747412136781,9,10,4,23,2.3014
1991716644473195_2381750752136447,2,0,0,2,1.2802
1991716644473195_2381756192135903,6,1,0,7,3.1646
1991716644473195_2381781898799999,4,0,0,4,1.7588
1991716644473195_2381804395464416,9,4,0,13,4.6172
1991716644473195_2381810502130472,7,0,0,7,3.5049
1991716644473195_2381817295463126,4,0,0,4,2.7343
1991716644473195_2382417345403121,2,0,0,2,1.1812
1991716644473195_2382530442058478,23,2,0,25,13.7631
1991716644473195_2382538442057678,1,0,0,1,0.4939
1991716644473195_2382597842051738,1,0,0,1,0.4215
1991716644473195_2382729915371864,1,0,0,1,0.4404
1991716644473195_2382757542035768,14,0,0,14,9.4732
1991716644473195_2382935758684613,23,1,0,24,12.1774
1991716644473195_2383115631999959,10,0,0,10,4.8018
1991716644473195_2383573335287522,1,0,0,1,0.7947
1991716644473195_2383699381941584,10,3,2,15,5.021
1991716644473195_2383917921919730,1,0,0,1,0.4215
1991716644473195_2384370631874459,6,0,0,6,2.6844
1991716644473195_2386174948360694,5,0,0,5,2.1642
1991716644473195_2386513971660125,19,4,0,23,12.2474
1991716644473195_2386670261644496,1,0,0,1,0.4215
1991716644473195_2387575128220676,1,3,0,4,0.6597
1991716644473195_2388898158088373,6,0,0,6,3.4534
1991716644473195_2389169274727928,11,1,0,12,5.5711
1991716644473195_2389845924660263,5,4,0,9,2.4088
1991716644473195_2390045601306962,1,0,0,1,0.969
1991716644473195_2390941824550673,4,1,0,5,1.5944
1991716644473195_2391637634481092,1,0,0,1,0.9331
1991716644473195_2391801457798043,9,3,3,15,2.821
1991716644473195_2391877561123766,1,1,0,2,0.5106
1991716644473195_2391887297789459,3,0,0,3,1.7982
1991716644473195_2391888164456039,4,0,0,4,2.2545
1991716644473195_2392069647771224,1,0,0,1,0.5994
1991716644473195_2392547904390065,1,1,0,2,0.4215
1991716644473195_2392723267705862,0,8,0,8,0
1991716644473195_2392745077703681,1,0,0,1,0.4404
1991716644473195_2392786707699518,3,1,0,4,1.7902
1991716644473195_2393140054330850,0,1,0,1,0
1991716644473195_2393489700962552,1,0,0,1,0.4754
1991716644473195_2393569270954595,1,1,0,2,0.4404
1991716644473195_2393658730945649,2,0,0,2,0.843
1991716644473195_2393662980945224,6,1,0,7,2.8989
1991716644473195_2393729694271886,0,1,0,1,0
1991716644473195_2393731200938402,1,1,0,2,0.8271
1991716644473195_2393732220938300,2,1,0,3,0.9244
1991716644473195_2394009724243883,2,2,0,4,0.9508
1991716644473195_2394072304237625,15,10,0,25,7.8035
1991716644473195_2394475864197269,1,0,0,1,0.4754
1991716644473195_2394688007509388,5,15,1,21,1.9134
1991716644473195_2394694697508719,1,5,0,6,0.6124
1991716644473195_2394784970833025,5,0,0,5,2.5606
1991716644473195_2394894100822112,3,4,1,8,1.1121
1991716644473195_2395500977428091,0,1,0,1,0
1991716644473195_2395847834060072,1,1,0,2,0.1027
1991716644473195_2396503637327825,1,0,0,1,0.6249
1991716644473195_2396550510656471,0,2,0,2,0
1991716644473195_2396706717307517,2,0,0,2,0.9993
1991716644473195_2397072880604234,0,2,0,2,0
1991716644473195_2397081053936750,1,0,0,1,0.6908
1991716644473195_2397487557229433,1,0,0,1,0.4404
1991716644473195_2397509120560610,1,3,0,4,0.4404
1991716644473195_2398173330494189,2,1,0,3,1.1261
1991716644473195_2398695690441953,17,4,1,22,8.6674
1991716644473195_2398868690424653,2,0,0,2,0.8969
1991716644473195_2398928130418709,3,3,0,6,1.3023
1991716644473195_2399497163695139,1,6,1,8,-0.0201
1991716644473195_2399520967026092,1,0,0,1,0.4215
1991716644473195_2399596107018578,1,2,0,3,0.5994
1991716644473195_2399619507016238,2,0,0,2,0.8808
1991716644473195_2399783743666481,1,0,0,1,0.4404
1991716644473195_2399829733661882,3,3,0,6,1.1465
1991716644473195_2399914473653408,5,0,0,5,2.8233
1991716644473195_2400431716935017,1,1,0,2,0.5994
1991716644473195_2400553103589545,2,0,0,2,1.2368
1991716644473195_2400610166917172,0,2,0,2,0
1991716644473195_2401415246836664,24,1,0,25,14.2878
1991716644473195_2401482600163262,0,1,0,1,0
1991716644473195_2401573790154143,9,2,0,11,4.2599
1991716644473195_2401589360152586,1,0,0,1,0.6249
1991716644473195_2401662903478565,8,2,0,10,4.039
1991716644473195_2401678410143681,1,0,0,1,0.4754
1991716644473195_2402608766717312,6,0,0,6,3.3105
1991716644473195_2402656496712539,1,0,0,1,0.8816
1991716644473195_2402680340043488,1,0,0,1,0.6249
1991716644473195_2403217083323147,17,3,0,20,9.2733
1991716644473195_2403334566644732,5,0,0,5,2.9762
1991716644473195_2403449093299946,2,0,0,2,1.0464
1991716644473195_2403454873299368,24,1,0,25,11.9018
1991716644473195_2403458223299033,0,1,0,1,0
1991716644473195_2403488703295985,1,0,0,1,0.4754
1991716644473195_2403685873276268,1,1,0,2,0.4404
1991716644473195_2403698883274967,12,4,0,16,5.8085
1991716644473195_2403735679937954,6,2,0,8,2.9204
1991716644473195_2403861229925399,5,0,0,5,2.9309
1991716644473195_2403930756585113,1,0,0,1,0.5413
1991716644473195_2403936853251170,9,1,0,10,4.4655
1991716644473195_2403956013249254,8,0,1,9,4.1975
1991716644473195_2404190699892452,3,7,4,14,-0.0758
1991716644473195_2404376483207207,7,1,0,8,3.6966
1991716644473195_2404452379866284,1,0,0,1,0.6808
1991716644473195_2404507496527439,9,1,0,10,5.8704
1991716644473195_2404587023186153,1,4,0,5,0.0772
1991716644473195_2405373893107466,2,0,0,2,0.8808
1991716644473195_2405504933094362,2,0,0,2,1.1662
1991716644473195_2405595076418681,1,0,0,1,0.4404
1991716644473195_2405595573085298,2,1,0,3,0.8969
1991716644473195_2405638083081047,2,4,0,6,1.0209
1991716644473195_2406354756342713,0,1,0,1,0
1991716644473195_2406355356342653,23,2,0,25,11.0018
1991716644473195_2406359316342257,16,4,0,20,8.0672
1991716644473195_2406560632988792,1,1,0,2,0.6808
1991716644473195_2406573132987542,5,1,0,6,2.3648
1991716644473195_2406717162973139,2,2,0,4,1.3466
1991716644473195_2406803272964528,8,1,0,9,3.9406
1991716644473195_2407370996241089,9,2,0,11,4.4594
1991716644473195_2407444519567070,24,1,0,25,12.0542
1991716644473195_2407457572899098,16,1,0,17,7.7642
1991716644473195_2407525006225688,15,10,0,25,9.153
1991716644473195_2407580259553496,4,0,0,4,2.1656
1991716644473195_2407836962861159,1,11,1,13,0.1979
1991716644473195_2408075942837261,5,1,0,6,2.6842
1991716644473195_2408139829497539,1,0,0,1,0.8415
1991716644473195_2408304229481099,0,1,0,1,0
1991716644473195_2408328129478709,3,1,0,4,1.3912
1991716644473195_2408399702804885,15,1,0,16,7.6582
1991716644473195_2408422176135971,11,3,0,14,6.0212
1991716644473195_2408469956131193,5,0,0,5,2.2515
1991716644473195_2408546949456827,7,1,0,8,3.4949
1991716644473195_2408572836120905,22,3,0,25,11.5772
1991716644473195_2408746159436906,0,2,0,2,0
1991716644473195_2409266686051520,8,1,0,9,3.4287
1991716644473195_2409275926050596,9,1,0,10,4.4658
1991716644473195_2409295046048684,4,0,0,4,1.7938
1991716644473195_2409329862711869,7,1,0,8,4.7052
1991716644473195_2409424936035695,2,18,5,25,-1.6301
1991716644473195_2409432119368310,0,1,0,1,0
1991716644473195_2409454312699424,3,6,1,10,-0.1703
1991716644473195_2409608142684041,13,0,0,13,7.2713
1991716644473195_2410242885953900,2,0,0,2,0.8619
1991716644473195_2410245042620351,4,4,1,9,1.384
1991716644473195_2410346162610239,2,0,0,2,0.8619
1991716644473195_2411106682534187,0,1,0,1,0
1991716644473195_2411231419188380,1,0,0,1,0.4404
1991716644473195_2411324272512428,1,0,0,1,0.4754
1991716644473195_2411342735843915,2,3,0,5,0.9508
1991716644473195_2411441052500750,4,2,0,6,2.2837
1991716644473195_2412077785770410,1,0,0,1,0.5859
1991716644473195_2412296132415242,15,6,0,21,9.0115
1991716644473195_2412317042413151,1,1,0,2,0.7003
1991716644473195_2412364855741703,1,0,0,1,0.5719
1991716644473195_2412490669062455,2,0,0,2,0.9158
1991716644473195_2412494689062053,5,1,0,6,2.9306
1991716644473195_2412517145726474,2,0,0,2,0.843
1991716644473195_2412597859051736,7,0,0,7,4.1784
1991716644473195_2412710272373828,1,0,0,1,0.6249
1991716644473195_2412773875700801,9,6,0,15,4.5606
1991716644473195_2413117828999739,2,0,0,2,1.0398
1991716644473195_2413121018999420,4,0,0,4,1.795
1991716644473195_2413220865656102,1,0,0,1,0.4404
1991716644473195_2413241958987326,4,1,0,5,1.7966
1991716644473195_2413299088981613,2,0,0,2,0.9343
1991716644473195_2413350115643177,2,0,0,2,0.9854
1991716644473195_2413355832309272,1,1,0,2,0.34
1991716644473195_2413373638974158,4,0,0,4,2.5451
1991716644473195_2413397732305082,5,0,0,5,2.5522
1991716644473195_2413448928966629,2,0,0,2,1.1003
1991716644473195_2413467398964782,1,0,0,1,0.4404
1991716644473195_2413520978959424,4,0,0,4,1.7238
1991716644473195_2413664368945085,1,0,0,1,0.6249
1991716644473195_2414044102240445,1,5,0,6,0.5719
1991716644473195_2414063025571886,2,1,1,4,0.8867
1991716644473195_2414089835569205,1,1,0,2,0.6249
1991716644473195_2414196992225156,3,0,0,3,1.4112
1991716644473195_2414246202220235,2,0,0,2,1.3657
1991716644473195_2414280905550098,19,6,0,25,8.7326
1991716644473195_2414300865548102,5,1,0,6,2.4026
1991716644473195_2414376832207172,1,2,0,3,0.4404
1991716644473195_2414385365539652,10,3,0,13,5.1819
1991716644473195_2414390392205816,1,0,0,1,0.4404
1991716644473195_2414441068867415,3,1,0,4,1.6862
1991716644473195_2414444082200447,8,1,0,9,5.0501
1991716644473195_2414474052197450,2,2,0,4,1.0765
1991716644473195_2414531715525017,2,1,0,3,1.0653
1991716644473195_2414627242182131,0,15,2,17,-0.3476
1991716644473195_2414651088846413,1,0,0,1,0.4754
1991716644473195_2414888768822645,1,1,0,2,0.4215
1991716644473195_2415233308788191,1,1,0,2,0.6249
1991716644473195_2415259252118930,22,3,0,25,10.744
1991716644473195_2415279765450212,1,1,0,2,0.5994
1991716644473195_2415303392114516,0,14,1,15,-0.4019
1991716644473195_2415306245447564,4,0,0,4,2.5637
1991716644473195_2415319725446216,2,0,0,2,0.8969
1991716644473195_2415346955443493,2,0,0,2,1.206
1991716644473195_2415368365441352,7,2,0,9,3.3896
1991716644473195_2415373618774160,1,0,0,1,0.4215
1991716644473195_2415384872106368,7,2,0,9,4.3094
1991716644473195_2415571398754382,3,1,0,4,1.2834
1991716644473195_2415595752085280,6,0,0,6,3.1888
1991716644473195_2415607458750776,1,2,0,3,0.4215
1991716644473195_2415610152083840,1,0,0,1,0.4215
1991716644473195_2415651568746365,0,1,0,1,0
1991716644473195_2416048705373318,1,0,0,1,0.4215
1991716644473195_2416070602037795,20,5,0,25,12.0611
1991716644473195_2416202072024648,1,0,0,1,0.4404
1991716644473195_2416204072024448,10,0,0,10,5.7427
1991716644473195_2416222778689244,23,2,0,25,11.2943
1991716644473195_2416230425355146,3,0,0,3,1.4338
1991716644473195_2416263105351878,5,0,0,5,2.1642
1991716644473195_2416273392017516,1,0,0,1,0.4404
1991716644473195_2416315018680020,3,0,0,3,1.3212
1991716644473195_2416343868677135,8,0,0,8,4.1812
1991716644473195_2416347425343446,0,1,0,1,0
1991716644473195_2416377165340472,2,0,0,2,0.843
1991716644473195_2416383138673208,1,0,0,1,0.4404
1991716644473195_2416386208672901,2,1,0,3,0.8619
1991716644473195_2416387555339433,2,2,0,4,1.0653
1991716644473195_2416549548656567,2,1,0,3,0.8808
1991716644473195_2416605278650994,1,4,0,5,0.5719
1991716644473195_2416634185314770,1,1,0,2,0.4404
1991716644473195_2416814591963396,6,0,0,6,2.8052
1991716644473195_2416916721953183,2,0,0,2,0.8808
1991716644473195_2417019401942915,1,0,0,1,0.4404
1991716644473195_2417105285267660,2,0,0,2,1.0653
1991716644473195_2417201228591399,3,3,0,6,0.9982
1991716644473195_2417345065243682,5,0,0,5,2.8596
1991716644473195_2417397008571821,9,0,0,9,5.0267
1991716644473195_2417783915199797,12,9,0,21,5.8098
1991716644473195_2417821295196059,15,2,0,17,7.8992
1991716644473195_2417887515189437,3,0,0,3,1.5057
1991716644473195_2417942028517319,2,0,0,2,1.7301
1991716644473195_2417959631848892,9,1,0,10,5.2178
1991716644473195_2418293948482127,3,1,1,5,0.8841
1991716644473195_2418658291779026,9,0,0,9,4.7159
1991716644473195_2418789848432537,1,4,0,5,0.296
1991716644473195_2418947235083465,9,1,0,10,4.6086
1991716644473195_2418948765083312,7,1,0,8,3.5083
1991716644473195_2418973301747525,16,5,0,21,7.4728
1991716644473195_2419000995078089,1,0,0,1,0.4404
1991716644473195_2419018115076377,2,0,0,2,1.1003
1991716644473195_2419031188408403,1,0,0,1,0.4404
1991716644473195_2419057141739141,8,2,0,10,3.9978
1991716644473195_2419084978403024,7,0,0,7,4.1958
1991716644473195_2419090665069122,1,0,0,1,0.4404
1991716644473195_2419210001723855,2,1,0,3,1.0464
1991716644473195_2419242711720584,11,2,0,13,5.0324
1991716644473195_2419306321714223,2,0,0,2,0.8414
1991716644473195_2419361271708728,1,0,0,1,0.4927
1991716644473195_2419695298341992,1,0,0,1,0.9702
1991716644473195_2419784848333037,1,1,1,3,-0.2259
1991716644473195_2419801448331377,1,2,0,3,0.3612
1991716644473195_2419822298329292,4,0,0,4,1.7427
1991716644473195_2419872174990971,4,0,0,4,2.0418
1991716644473195_2419878298323692,1,0,0,1,0.4215
1991716644473195_2419899431654912,1,0,0,1,0.8016
1991716644473195_2419900874988101,1,0,0,1,0.4199
1991716644473195_2419937751651080,1,1,2,4,-0.5574
1991716644473195_2419949541649901,3,5,0,8,1.8037
1991716644473195_2419986454979543,4,2,1,7,2.4977
1991716644473195_2419996798311842,3,0,0,3,1.3641
1991716644473195_2420040741640781,3,0,0,3,1.3558
1991716644473195_2420075404970648,1,0,0,1,0.4754
1991716644473195_2420098631634992,1,0,0,1,0.4404
1991716644473195_2420135894964599,7,7,1,15,2.3991
1991716644473195_2420168534961335,21,2,1,24,11.503
1991716644473195_2420173718294150,2,0,0,2,1.1744
1991716644473195_2420187601626095,0,1,0,1,0
1991716644473195_2420243621620493,0,1,0,1,0
1991716644473195_2420264568285065,2,1,0,3,1.0653
1991716644473195_2420314138280108,7,1,0,8,3.4216
1991716644473195_2420622224915966,3,0,0,3,1.1612
1991716644473195_2420703351574520,2,0,0,2,0.8619
1991716644473195_2420741854904003,1,0,0,1,0.4215
1991716644473195_2420790838232438,1,0,0,1,0.5106
1991716644473195_2420810258230496,3,0,0,3,1.5057
1991716644473195_2420851208226401,2,0,0,2,1.0653
1991716644473195_2420903698221152,20,5,0,25,9.6592
1991716644473195_2420923121552543,5,2,0,7,2.6698
1991716644473195_2420927538218768,22,3,0,25,10.2136
1991716644473195_2420934161551439,2,2,1,5,1.169
1991716644473195_2420938718217650,8,2,0,10,3.9942
1991716644473195_2420947294883459,10,4,1,15,4.4512
1991716644473195_2420968564881332,0,1,0,1,0
1991716644473195_2421040291540826,1,0,0,1,0.4927
1991716644473195_2421040744874114,12,0,0,12,6.1397
1991716644473195_2421212171523638,1,0,0,1,0.4215
1991716644473195_2421244051520450,1,0,0,1,0.4404
1991716644473195_2421264794851709,2,14,1,17,0.4626
1991716644473195_2421612264816962,1,0,0,1,0.1779
1991716644473195_2421645801480275,3,0,0,3,1.3373
1991716644473195_2421647448146777,3,3,0,6,1.8232
1991716644473195_2421661424812046,1,1,0,2,0.4215
1991716644473195_2421683258143196,1,0,0,1,0.4404
1991716644473195_2421746414803547,2,0,0,2,1.3905
1991716644473195_2421815204796668,3,3,3,9,0.497
1991716644473195_2421818894796299,4,0,0,4,1.83
1991716644473195_2421830261461829,3,0,0,3,1.7849
1991716644473195_2421833568128165,5,3,1,9,2.4944
1991716644473195_2421853734792815,1,1,0,2,0.3612
1991716644473195_2421866744791514,6,1,0,7,3.0508
1991716644473195_2421944671450388,1,0,0,1,0.2023
1991716644473195_2421979984780190,4,1,0,5,2.1053
1991716644473195_2421982244779964,6,0,0,6,2.9373
1991716644473195_2422011541443701,1,0,0,1,0.8481
1991716644473195_2422014644776724,1,1,0,2,0.4215
1991716644473195_2422023018109220,22,3,0,25,11.4743
1991716644473195_2422191414759047,4,1,0,5,2.3186
1991716644473195_2422507784727410,9,1,0,10,3.9781
1991716644473195_2422612941383561,1,0,0,1,0.5859
1991716644473195_2422674264710762,6,17,2,25,0.3695
1991716644473195_2422691874709001,0,2,0,2,0
1991716644473195_2422699098041612,3,1,0,4,1.6583
1991716644473195_2422704768041045,7,14,1,22,3.0749
1991716644473195_2422740158037506,1,0,0,1,0.6249
1991716644473195_2422796184698570,6,0,0,6,2.5254
1991716644473195_2422850288026493,6,1,0,7,3.0436
1991716644473195_2422877864690402,0,2,0,2,0
1991716644473195_2422910344687154,1,0,1,2,0.4435
1991716644473195_2422926694685519,3,1,0,4,1.5842
1991716644473195_2422963354681853,1,0,0,1,0.4199
1991716644473195_2422981528013369,5,0,0,5,2.6139
1991716644473195_2423030201341835,1,0,0,1,0.4404
1991716644473195_2423030644675124,2,1,0,3,0.7136
1991716644473195_2423039631340892,1,0,0,1,0.7531
1991716644473195_2423041898007332,7,18,0,25,3.6891
1991716644473195_2423076734670515,0,1,0,1,0
1991716644473195_2423102728001249,3,1,0,4,1.4679
1991716644473195_2423137794664409,1,0,0,1,0.7003
1991716644473195_2423169684661220,21,4,0,25,11.6064
1991716644473195_2423565347954987,4,8,0,12,1.999
1991716644473195_2423580417953480,2,0,0,2,0.843
1991716644473195_2423613557950166,0,1,0,1,0
1991716644473195_2423637057947816,5,0,0,5,2.4619
1991716644473195_2423659967945525,11,2,0,13,5.6821
1991716644473195_2423660307945491,1,1,0,2,0.9333
1991716644473195_2423660767945445,0,1,0,1,0
1991716644473195_2423672947944227,3,6,1,10,0.4654
1991716644473195_2423704714607717,3,3,2,8,0.7983
1991716644473195_2423728557938666,1,0,0,1,0.4215
1991716644473195_2423783831266472,2,1,1,4,0.6371
1991716644473195_2423825757928946,2,10,1,13,1.1472
1991716644473195_2423827907928731,17,8,0,25,8.9338
1991716644473195_2423862194591969,1,0,0,1,0.4404
1991716644473195_2423877817923740,6,0,0,6,3.1005
1991716644473195_2423878197923702,3,0,0,3,1.6458
1991716644473195_2423886834589505,5,1,0,6,2.838
1991716644473195_2423896061255249,9,2,0,11,4.7054
1991716644473195_2423926171252238,3,1,0,4,1.5218
1991716644473195_2423939344584254,0,1,0,1,0
1991716644473195_2423981461246709,0,1,0,1,0
1991716644473195_2424032171241638,11,3,0,14,6.759
1991716644473195_2424741497837372,2,0,0,2,0.9158
1991716644473195_2425017874476401,14,11,0,25,7.024
1991716644473195_2425032531141602,2,3,0,5,0.8726
1991716644473195_2425554417756080,1,0,0,1,0.4404
1991716644473195_2425702181074637,4,3,0,7,1.7105
1991716644473195_2425711344407054,2,2,0,4,0.8619
1991716644473195_2425724031072452,7,3,0,10,3.6206
1991716644473195_2425755284402660,0,1,0,1,0
1991716644473195_2425795401065315,1,1,0,2,0.3612
1991716644473195_2425845964393592,3,1,0,4,2.3845
1991716644473195_2425846641060191,1,0,0,1,0.7003
1991716644473195_2425950951049760,6,8,1,15,3.1094
1991716644473195_2426204414357747,1,0,0,1,0.5719
1991716644473195_2426531410991714,1,0,0,1,0.4215
1991716644473195_2426538150991040,2,11,3,16,0.3578
1991716644473195_2426598434318345,1,0,0,1,0.5859
1991716644473195_2426708960973959,4,3,0,7,2.2066
1991716644473195_2426731927638329,2,2,0,4,1.1988
1991716644473195_2426737167637805,2,3,1,6,0.1212
1991716644473195_2426738830970972,11,0,0,11,4.8625
1991716644473195_2426745204303668,1,5,0,6,0.4215
1991716644473195_2426783744299814,0,1,0,1,0
1991716644473195_2426791497632372,4,1,0,5,2.5392
1991716644473195_2426826250962230,1,0,0,1,0.6249
1991716644473195_2426870517624470,11,0,0,11,5.0254
1991716644473195_2426871214291067,4,1,0,5,1.3532
1991716644473195_2426875727623949,4,0,0,4,1.7427
1991716644473195_2426898517621670,17,8,0,25,11.0834
1991716644473195_2426902774287911,0,4,0,4,0
1991716644473195_2426908480954007,2,3,0,5,1.0528
1991716644473195_2426953684282820,9,5,0,14,5.6025
1991716644473195_2426960877615434,1,1,0,2,0.4588
1991716644473195_2426966947614827,1,0,0,1,0.4927
1991716644473195_2426973557614166,0,15,1,16,-0.3736
1991716644473195_2426980357613486,0,1,0,1,0
1991716644473195_2427033650941490,0,4,1,5,-0.7906
1991716644473195_2427139504264238,4,5,0,9,1.4988
1991716644473195_2427148737596648,2,0,0,2,0.68
1991716644473195_2427172510927604,7,5,2,14,2.9007
1991716644473195_2427213520923503,3,0,0,3,1.4802
1991716644473195_2427243020920553,1,0,0,1,0.6361
1991716644473195_2427506867560835,6,0,0,6,3.7738
1991716644473195_2427524114225777,3,0,0,3,1.3896
1991716644473195_2427533734224815,4,1,0,5,2.3976
1991716644473195_2427534924224696,0,2,0,2,0
1991716644473195_2427588450886010,0,2,2,4,-0.8227
1991716644473195_2427601320884723,1,0,0,1,0.5994
1991716644473195_2427613910883464,2,5,0,7,1.0013
1991716644473195_2427629090881946,1,4,0,5,0.5994
1991716644473195_2427673374210851,10,7,0,17,5.5316
1991716644473195_2427680397543482,3,0,0,3,1.7982
1991716644473195_2427681477543374,3,0,0,3,1.7052
1991716644473195_2427714060873449,3,1,1,5,0.8139
1991716644473195_2427719404206248,2,2,0,4,0.5539
1991716644473195_2427734520871403,3,1,0,4,1.406
1991716644473195_2427737470871108,5,7,0,12,2.0533
1991716644473195_2427746390870216,1,1,0,2,0.4404
1991716644473195_2427763337535188,18,4,0,22,9.7859
1991716644473195_2427767780868077,2,0,0,2,1.1261
1991716644473195_2427786987532823,3,0,0,3,1.2906
1991716644473195_2427790294199159,1,0,0,1,0.6249
1991716644473195_2427793044198884,1,0,0,1,0.4404
1991716644473195_2427808777530644,1,1,0,2,0.5994
1991716644473195_2427823484195840,2,2,0,4,1.1988
1991716644473195_2427834210861434,3,0,0,3,1.3357
1991716644473195_2427857730859082,2,0,0,2,1.1988
1991716644473195_2427870900857765,4,2,0,6,1.8127
1991716644473195_2427884980856357,2,0,0,2,1.1988
1991716644473195_2427900824188106,1,0,1,2,0.1444
1991716644473195_2427903104187878,1,0,0,1,0.5994
1991716644473195_2427905604187628,1,0,0,1,0.5994
1991716644473195_2427921087519413,2,0,0,2,1.1261
1991716644473195_2427929057518616,1,0,0,1,0.5994
1991716644473195_2427939984184190,4,0,0,4,1.8666
1991716644473195_2427941520850703,2,1,0,3,1.1003
1991716644473195_2427946184183570,5,0,0,5,2.8517
1991716644473195_2427951787516343,3,2,1,6,1.5936
1991716644473195_2427967444181444,1,0,0,1,0.4404
1991716644473195_2427986877512834,3,0,0,3,1.6392
1991716644473195_2427990200845835,1,0,0,1,0.4215
1991716644473195_2428031617508360,3,0,0,3,1.9952
1991716644473195_2428062034171985,1,0,0,1,0.5994
1991716644473195_2428073507504171,3,1,0,4,1.6576
1991716644473195_2428073804170808,1,0,0,1,0.5994
1991716644473195_2428080307503491,1,0,0,1,0.5994
1991716644473195_2428085684169620,2,0,1,3,0.8588
1991716644473195_2428130010831854,4,0,0,4,2.7792
1991716644473195_2428397537471768,1,0,0,1,0.4404
1991716644473195_2428428394135349,1,0,0,1,0.5994
1991716644473195_2428483740796481,5,0,0,5,3.0036
1991716644473195_2428501007461421,1,3,0,4,0.5994
1991716644473195_2428564850788370,4,0,0,4,2.257
1991716644473195_2428573830787472,1,0,0,1,0.6249
1991716644473195_2428577297453792,4,1,0,5,2.3976
1991716644473195_2428591777452344,1,0,0,1,0.4754
1991716644473195_2428604220784433,1,0,0,1,0.5994
1991716644473195_2428615214116667,2,2,0,4,0.7148
1991716644473195_2428624994115689,8,7,0,15,4.7225
1991716644473195_2428625174115671,5,3,0,8,3.0534
1991716644473195_2428646484113540,1,11,2,14,-0.247
1991716644473195_2428652794112909,1,0,0,1,0.4404
1991716644473195_2428657677445754,1,0,0,1,0.4215
1991716644473195_2428668407444681,0,1,0,1,0
1991716644473195_2428670170777838,7,1,0,8,3.725
1991716644473195_2428672200777635,4,0,0,4,2.3976
1991716644473195_2428681810776674,1,0,0,1,0.4754
1991716644473195_2428690770775778,2,0,0,2,1.1988
1991716644473195_2428705364107652,7,6,0,13,4.5172
1991716644473195_2428707187440803,1,1,0,2,0.4939
1991716644473195_2428708287440693,17,5,0,22,9.3817
1991716644473195_2428708917440630,3,0,0,3,1.7982
1991716644473195_2428710107440511,1,0,0,1,0.4404
1991716644473195_2428711217440400,3,1,0,4,1.152
1991716644473195_2428717774106411,1,0,0,1,0.4215
1991716644473195_2428719294106259,4,5,0,9,1.8754
1991716644473195_2428724254105763,3,11,1,15,0.5707
1991716644473195_2428745717436950,2,4,1,7,0.5959
1991716644473195_2428751240769731,1,0,0,1,0.6249
1991716644473195_2428752980769557,4,3,1,8,2.3459
1991716644473195_2428759644102224,2,3,0,5,1.1988
1991716644473195_2428773287434193,6,7,0,13,3.4208
1991716644473195_2428774487434073,1,0,0,1,0.4404
1991716644473195_2428789420765913,5,2,1,8,1.9808
1991716644473195_2428790110765844,2,0,0,2,1.1988
1991716644473195_2428797467431775,5,1,0,6,2.997
1991716644473195_2428798520765003,1,0,0,1,0.5994
1991716644473195_2428868217424700,0,6,1,7,-0.4019
1991716644473195_2428873700757485,0,1,0,1,0
1991716644473195_2428876317423890,1,0,0,1,0.7351
1991716644473195_2428886490756206,3,0,0,3,1.9705
1991716644473195_2428896504088538,1,1,0,2,0.4404
1991716644473195_2428908620753993,1,0,0,1,0.5994
1991716644473195_2428927974085391,9,1,0,10,4.5185
1991716644473195_2428934187418103,2,0,0,2,1.0398
1991716644473195_2428948397416682,1,0,0,1,0.5994
1991716644473195_2428955500749305,2,2,0,4,1.2118
1991716644473195_2428967104081478,1,1,0,2,0.4404
1991716644473195_2428973957414126,1,0,0,1,0.4404
1991716644473195_2428991540745701,2,0,0,2,1.1261
1991716644473195_2429002024077986,1,0,0,1,0.4215
1991716644473195_2429025907408931,3,1,0,4,1.6203
1991716644473195_2429038140741041,2,2,0,4,1.3644
1991716644473195_2429040390740816,3,0,0,3,1.9952
1991716644473195_2429045120740343,1,0,0,1,0.5994
1991716644473195_2429049574073231,3,0,0,3,1.7982
1991716644473195_2429055454072643,1,0,0,1,0.4404
1991716644473195_2429057197405802,2,3,0,5,1.0398
1991716644473195_2429057397405782,2,0,0,2,1.0398
1991716644473195_2429079450736910,1,0,0,1,0.5994
1991716644473195_2429093430735512,1,0,0,1,0.4404
1991716644473195_2429124934065695,2,0,0,2,1.1261
1991716644473195_2429126350732220,1,6,0,7,0.4404
1991716644473195_2429131027398419,1,1,0,2,0.4754
1991716644473195_2429212617390260,1,1,0,2,0.4404
1991716644473195_2429340010710854,3,1,0,4,1.2834
1991716644473195_2429382547373267,6,1,0,7,2.9864
1991716644473195_2429563460688509,1,1,0,2,0.4404
1991716644473195_2429583407353181,1,0,0,1,0.5994
1991716644473195_2429590610685794,1,2,0,3,0.5994
1991716644473195_2429595440685311,2,0,0,2,1.1988
1991716644473195_2429609254017263,3,1,0,4,1.117
1991716644473195_2429614007350121,0,2,0,2,0
1991716644473195_2429648207346701,8,13,4,25,1.5193
1991716644473195_2429728207338701,6,0,0,6,2.7997
1991716644473195_2429729464005242,1,0,0,1,0.5267
1991716644473195_2429734597338062,1,0,0,1,0.9472
1991716644473195_2429745197337002,1,0,0,1,0.5994
1991716644473195_2429751074003081,8,7,4,19,1.7729
1991716644473195_2429763634001825,4,0,0,4,2.3976
1991716644473195_2429808317330690,16,5,0,21,7.7883
1991716644473195_2429811120663743,1,0,0,1,0.4754
1991716644473195_2429812017330320,0,1,0,1,0
1991716644473195_2429815050663350,5,17,3,25,0.0957
1991716644473195_2429833927328129,2,2,1,5,0.6434
1991716644473195_2429839417327580,14,2,0,16,6.6626
1991716644473195_2429847043993484,0,1,0,1,0
1991716644473195_2429905950654260,0,1,1,2,-0.296
1991716644473195_2429920943986094,3,1,0,4,1.5888
1991716644473195_2429926870652168,1,1,0,2,0.5994
1991716644473195_2429929870651868,0,2,0,2,0
1991716644473195_2429946660650189,0,1,0,1,0
1991716644473195_2429948983983290,2,1,1,4,1.0684
1991716644473195_2429980580646797,1,0,0,1,0.5994
1991716644473195_2429996597311862,4,0,0,4,2.3976
1991716644473195_2430000210644834,0,1,0,1,0
1991716644473195_2430001703978018,1,1,0,2,0.5994
1991716644473195_2430043973973791,5,3,0,8,2.5103
1991716644473195_2430058440639011,1,2,0,3,0.34
1991716644473195_2430065850638270,0,1,0,1,0
1991716644473195_2430071523971036,5,3,1,9,1.8283
1991716644473195_2430075087304013,1,1,0,2,0.5994
1991716644473195_2430077317303790,2,0,0,2,1.1312
1991716644473195_2430093427302179,2,0,0,2,1.1988
1991716644473195_2430093903968798,2,1,0,3,1.1261
1991716644473195_2430096440635211,1,1,0,2,0.5994
1991716644473195_2430105770634278,1,1,0,2,0.5994
1991716644473195_2430116577299864,3,1,0,4,1.6392
1991716644473195_2430136613964527,1,1,0,2,0.5994
1991716644473195_2430164053961783,10,2,0,12,4.9613
1991716644473195_2430180013960187,1,1,0,2,0.5994
1991716644473195_2430504283927760,1,0,0,1,0.4404
1991716644473195_2430514087260113,1,2,0,3,0.5994
1991716644473195_2430525780592277,3,0,0,3,1.3218
1991716644473195_2430529047258617,3,1,0,4,1.7982
1991716644473195_2430535110591344,3,0,0,3,1.7255
1991716644473195_2430543860590469,1,1,0,2,0.5994
1991716644473195_2430566327254889,1,0,0,1,0.5994
1991716644473195_2430569160587939,1,1,0,2,0.5994
1991716644473195_2430595747251947,11,2,0,13,6.5787
1991716644473195_2430607367250785,1,1,0,2,0.5994
1991716644473195_2430608207250701,0,2,0,2,0
1991716644473195_2430610850583770,8,3,0,11,5.1264
1991716644473195_2430611230583732,1,0,0,1,0.5994
1991716644473195_2430625033915685,0,3,0,3,0
1991716644473195_2430629090581946,9,6,1,16,3.982
1991716644473195_2430646350580220,5,5,0,10,2.0994
1991716644473195_2430646507246871,11,5,0,16,6.4888
1991716644473195_2430657177245804,2,0,0,2,1.0013
1991716644473195_2430667467244775,5,12,2,19,0.8264
1991716644473195_2430668793911309,5,5,0,10,3.0406
1991716644473195_2430673083910880,1,9,1,11,0.0571
1991716644473195_2430680363910152,0,1,0,1,0
1991716644473195_2430682963909892,2,1,0,3,1.0653
1991716644473195_2430694360575419,0,1,0,1,0
1991716644473195_2430707143907474,2,1,0,3,1.0464
1991716644473195_2430717270573128,2,1,0,3,0.6572
1991716644473195_2430719863906202,3,3,0,6,1.5665
1991716644473195_2430727893905399,2,2,0,4,1.2108
1991716644473195_2430728077238714,3,0,0,3,1.7982
1991716644473195_2430732843904904,0,1,0,1,0
1991716644473195_2430739463904242,2,0,0,2,0.9176
1991716644473195_2430743790570476,1,1,0,2,0.5994
1991716644473195_2430760337235488,0,1,0,1,0
1991716644473195_2430760700568785,2,2,0,4,0.9693
1991716644473195_2430761243902064,3,0,0,3,1.401
1991716644473195_2430763990568456,1,1,0,2,0.5994
1991716644473195_2430765187235003,2,0,0,2,1.3178
1991716644473195_2430768050568050,0,1,0,1,0
1991716644473195_2430771467234375,3,1,0,4,1.7695
1991716644473195_2430778147233707,5,2,0,7,3.0899
1991716644473195_2430791420565713,1,0,0,1,0.5994
1991716644473195_2430807483897440,0,1,0,1,0
1991716644473195_2430820300562825,0,1,0,1,0
1991716644473195_2430851797226342,3,1,0,4,2.295
1991716644473195_2430860840558771,1,3,0,4,0.5994
1991716644473195_2430865247224997,2,0,0,2,0.8619
1991716644473195_2430870867224435,3,1,0,4,1.3546
1991716644473195_2430890207222501,1,0,0,1,0.5267
1991716644473195_2430902730554582,2,1,0,3,1.3958
1991716644473195_2430946807216841,2,1,0,3,0.9331
1991716644473195_2430968277214694,1,0,0,1,0.7717
1991716644473195_2430993323878856,4,1,0,5,2.1181
1991716644473195_2430993727212149,7,1,0,8,3.9641
1991716644473195_2430994710545384,2,1,0,3,1.1988
1991716644473195_2431023100542545,1,0,0,1,0.5994
1991716644473195_2431027440542111,1,0,0,1,0.5994
1991716644473195_2431030760541779,6,1,0,7,3.6047
1991716644473195_2431044590540396,3,1,0,4,1.4802
1991716644473195_2431081343870054,1,0,0,1,0.5994
1991716644473195_2431083173869871,8,1,0,9,3.6633
1991716644473195_2431109350533920,1,0,0,1,0.5994
1991716644473195_2431117153866473,1,0,0,1,0.5994
1991716644473195_2431122243865964,2,1,0,3,1.1988
1991716644473195_2431123767199145,1,1,0,2,0.5994
1991716644473195_2431138760530979,3,0,0,3,1.6458
1991716644473195_2431151653863023,1,0,0,1,0.6249
1991716644473195_2431163137195208,2,1,0,3,0.8808
1991716644473195_2431164537195068,3,3,0,6,1.3023
1991716644473195_2431280750516780,1,0,0,1,0.4404
1991716644473195_2431598390485016,0,1,0,1,0
1991716644473195_2431619287149593,0,3,1,4,-0.1027
1991716644473195_2431645733813615,3,0,0,3,2.0164
1991716644473195_2431723267139195,1,0,0,1,0.5994
1991716644473195_2431758943802294,1,1,0,2,0.5994
1991716644473195_2431764313801757,3,1,0,4,1.7982
1991716644473195_2431808310464024,3,2,0,5,1.8833
1991716644473195_2431811550463700,1,0,0,1,0.4215
1991716644473195_2431831340461721,3,2,0,5,1.7255
1991716644473195_2431841917127330,2,2,0,4,1.1988
1991716644473195_2431844790460376,1,1,0,2,0.5994
1991716644473195_2431855857125936,2,6,2,10,0.2699
1991716644473195_2431879070456948,1,3,1,5,0.3034
1991716644473195_2431879517123570,1,2,0,3,0.5994
1991716644473195_2431891127122409,2,0,0,2,0.8619
1991716644473195_2431910910453764,1,1,0,2,0.5994
1991716644473195_2431978297113692,0,1,0,1,0
1991716644473195_2432009683777220,1,0,0,1,0.5994
1991716644473195_2432046397106882,3,0,0,3,1.7255
1991716644473195_2432063807105141,0,1,0,1,0
1991716644473195_2432074460437409,3,1,0,4,1.56
1991716644473195_2432155873762601,3,3,0,6,1.7255
1991716644473195_2432163450428510,1,0,0,1,0.5994
1991716644473195_2432336263744562,1,1,0,2,0.5994
1991716644473195_2432449300399925,2,1,0,3,1.1261
1991716644473195_2432513453726843,1,0,0,1,0.5994
1991716644473195_2432534440391411,0,1,0,1,0
1991716644473195_2432548393723349,1,0,0,1,0.5994
1991716644473195_2432570883721100,0,1,0,1,0
1991716644473195_2432571083721080,0,3,0,3,0
1991716644473195_2432578443720344,2,1,0,3,1.1988
1991716644473195_2432615700383285,1,0,0,1,0.5994
1991716644473195_2432616950383160,1,0,0,1,0.5994
1991716644473195_2432620897049432,1,0,0,1,0.5994
1991716644473195_2432656233712565,2,1,0,3,1.1988
1991716644473195_2432658967045625,1,0,0,1,0.0772
1991716644473195_2432670230377832,1,0,0,1,0.5994
1991716644473195_2432672150377640,1,0,0,1,0.5994
1991716644473195_2432673783710810,1,0,0,1,0.4404
1991716644473195_2432682940376561,1,0,0,1,0.5267
1991716644473195_2432725910372264,0,1,0,1,0
1991716644473195_2432773893700799,0,2,0,2,0
1991716644473195_2432774933700695,0,1,0,1,0
1991716644473195_2432776593700529,5,2,0,7,2.3447
1991716644473195_2432789723699216,1,1,0,2,0.5994
1991716644473195_2432810803697108,1,0,0,1,0.0772
1991716644473195_2432823113695877,0,1,0,1,0
1991716644473195_2432831883695000,3,0,0,3,1.2834
1991716644473195_2432849357026586,2,1,0,3,1.0209
1991716644473195_2432866357024886,1,2,0,3,0.4404
1991716644473195_2432881483690040,2,1,0,3,0.8808
1991716644473195_2432894467022075,0,1,0,1,0
1991716644473195_2432896297021892,0,1,0,1,0
1991716644473195_2432896343688554,15,2,0,17,7.1708
1991716644473195_2432899603688228,0,2,0,2,0
1991716644473195_2432912660353589,7,0,0,7,4.8132
1991716644473195_2432934587018063,1,0,0,1,0.5994
1991716644473195_2432934797018042,17,1,0,18,10.668
1991716644473195_2432935133684675,1,1,0,2,0.5994
1991716644473195_2432937340351121,0,1,0,1,0
1991716644473195_2432937590351096,2,4,0,6,1.1988
1991716644473195_2432964930348362,0,1,0,1,0
1991716644473195_2432965973681591,1,2,0,3,0.4404
1991716644473195_2432974740347381,13,1,0,14,7.5276
1991716644473195_2432989307012591,2,0,0,2,0.5176
1991716644473195_2432992273678961,1,0,0,1,0.5994
1991716644473195_2433000433678145,1,0,0,1,0.5859
1991716644473195_2433015483676640,1,1,0,2,0.4215
1991716644473195_2433020907009431,12,3,0,15,6.3359
1991716644473195_2433025340342321,3,1,0,4,1.3373
1991716644473195_2433044293673759,4,2,0,6,1.8828
1991716644473195_2433045230340332,2,1,0,3,1.1988
1991716644473195_2433069127004609,0,1,0,1,0
1991716644473195_2433083840336471,2,2,0,4,0.7586
1991716644473195_2433084347003087,5,2,0,7,2.8433
1991716644473195_2433094087002113,3,1,0,4,1.7982
1991716644473195_2433111620333693,1,1,0,2,0.5994
1991716644473195_2433169033661285,3,2,0,5,1.7553
1991716644473195_2433387950306060,1,1,0,2,0.5994
1991716644473195_2433412296970292,2,1,0,3,1.1988
1991716644473195_2433418173636371,0,1,0,1,0
1991716644473195_2433435980301257,2,5,0,7,1.0398
1991716644473195_2433439563634232,0,1,0,1,0
1991716644473195_2433483180296537,1,1,0,2,0.5994
1991716644473195_2433504203627768,12,3,0,15,6.9121
1991716644473195_2433515246959997,5,6,1,12,1.486
1991716644473195_2433521603626028,0,1,0,1,0
1991716644473195_2433531916958330,2,1,0,3,1.0398
1991716644473195_2433539483624240,0,1,0,1,0
1991716644473195_2433541920290663,2,2,0,4,1.1988
1991716644473195_2433553250289530,0,2,0,2,0
1991716644473195_2433555326955989,0,1,0,1,0
1991716644473195_2433555860289269,0,1,0,1,0
1991716644473195_2433583210286534,0,1,0,1,0
1991716644473195_2433593036952218,6,4,1,11,3.1208
1991716644473195_2433616890283166,5,1,0,6,2.5534
1991716644473195_2433617870283068,1,1,1,3,0.2307
1991716644473195_2433633740281481,1,1,0,2,0.4215
1991716644473195_2433641976947324,0,1,0,1,0
1991716644473195_2433643403613848,1,1,0,2,0.5994
1991716644473195_2433653966946125,2,1,0,3,1.0209
1991716644473195_2433660920278763,1,1,0,2,0.5994
1991716644473195_2433669606944561,0,1,0,1,0
1991716644473195_2433672890277566,3,3,0,6,1.3373
1991716644473195_2433692203608968,0,1,0,1,0
1991716644473195_2433692526942269,1,1,0,2,0.4404
1991716644473195_2433717680273087,0,1,0,1,0
1991716644473195_2433719470272908,0,2,0,2,0
1991716644473195_2433721280272727,0,1,0,1,0
1991716644473195_2433723236939198,0,2,0,2,0
1991716644473195_2433724233605765,2,2,0,4,0.4046
1991716644473195_2433733496938172,1,1,0,2,0.4404
1991716644473195_2433738873604301,1,1,0,2,0.5994
1991716644473195_2433740043604184,1,1,0,2,0.9738
1991716644473195_2433762503601938,5,2,0,7,2.8943
1991716644473195_2433764026935119,0,2,0,2,0
1991716644473195_2433765150268340,2,2,0,4,0.8619
1991716644473195_2433767530268102,1,0,0,1,0.0772
1991716644473195_2433771500267705,5,1,0,6,2.6861
1991716644473195_2433776723600516,2,2,0,4,1.1988
1991716644473195_2433777373600451,1,1,0,2,0.4215
1991716644473195_2433788056932716,3,2,0,5,1.4963
1991716644473195_2433797690265086,1,1,0,2,0.6908
1991716644473195_2433809623597226,20,5,0,25,10.7382
1991716644473195_2433811060263749,6,3,0,9,2.6812
1991716644473195_2433815143596674,5,2,0,7,2.3797
1991716644473195_2433817843596404,1,1,0,2,0.5719
1991716644473195_2433828453595343,2,1,0,3,0.8619
1991716644473195_2433832460261609,1,1,0,2,0.4215
1991716644473195_2433838183594370,1,1,0,2,0.5994
1991716644473195_2433840146927507,1,1,0,2,0.4215
1991716644473195_2433849176926604,2,1,0,3,0.8619
1991716644473195_2433849453593243,1,1,0,2,0.4754
1991716644473195_2433854793592709,2,1,0,3,1.1988
1991716644473195_2433879613590227,1,2,0,3,0.4404
1991716644473195_2433887603589428,1,1,0,2,0.5719
1991716644473195_2433899953588193,0,2,0,2,0
1991716644473195_2433904593587729,1,1,0,2,0.5994
1991716644473195_2433911876920334,1,1,0,2,0.4215
1991716644473195_2433945516916970,1,1,0,2,0.4404
1991716644473195_2433979750246880,2,2,0,4,1.1988
1991716644473195_2434004100244445,1,1,0,2,0.4588
1991716644473195_2434008300244025,8,4,1,13,3.1299
1991716644473195_2434033560241499,1,1,0,2,0.6249
1991716644473195_2434058820238973,5,1,1,7,2.3702
1991716644473195_2434294170215438,8,1,0,9,3.7198
1991716644473195_2434362360208619,0,1,0,1,0
1991716644473195_2434403593537829,0,1,0,1,0
1991716644473195_2434426266868895,1,1,0,2,0.5994
1991716644473195_2434429333535255,1,1,0,2,0.4215
1991716644473195_2434444240200431,21,4,0,25,10.6853
1991716644473195_2434459860198869,3,1,0,4,1.2834
1991716644473195_2434483573529831,2,1,0,3,0.8619
1991716644473195_2434485096863012,4,1,0,5,1.8078
1991716644473195_2434491686862353,0,1,0,1,0
1991716644473195_2434539643524224,2,1,0,3,0.8619
1991716644473195_2434546423523546,2,1,0,3,1.2243
1991716644473195_2434548320190023,1,2,1,4,-0.1728
1991716644473195_2434560596855462,3,0,0,3,1.5675
1991716644473195_2434564543521734,7,11,1,19,2.8394
1991716644473195_2434571790187676,20,5,0,25,10.5887
1991716644473195_2434572976854224,1,1,0,2,0.5994
1991716644473195_2434577686853753,0,1,0,1,0
1991716644473195_2434582246853297,5,1,0,6,2.5612
1991716644473195_2434594443518744,0,1,0,1,0
1991716644473195_2434618006849721,0,1,0,1,0
1991716644473195_2434619060182949,3,1,0,4,1.3023
1991716644473195_2434620693516119,7,0,0,7,3.8602
1991716644473195_2434640790180776,0,1,0,1,0
1991716644473195_2434649166846605,4,4,0,8,2.3312
1991716644473195_2434681103510078,1,1,0,2,0.4927
1991716644473195_2434683740176481,1,14,2,17,-0.5282
1991716644473195_2434726560172199,8,0,0,8,4.4006
1991716644473195_2434730626838459,2,1,0,3,1.0464
1991716644473195_2434759090168946,3,1,0,4,1.7518
1991716644473195_2434772140167641,2,0,0,2,0.8808
1991716644473195_2434782110166644,1,1,0,2,0.4927
1991716644473195_2434798870164968,2,1,0,3,0.8366
1991716644473195_2434804973497691,3,2,0,5,1.6915
1991716644473195_2434808066830715,2,1,0,3,1.0464
1991716644473195_2434813773496811,0,1,0,1,0
1991716644473195_2434829723495216,1,0,0,1,0.4404
1991716644473195_2434831176828404,2,1,0,3,0.843
1991716644473195_2434856290159226,2,1,0,3,1.3644
1991716644473195_2434889270155928,1,0,0,1,0.4927
1991716644473195_2434895973488591,1,1,0,2,0.4404
1991716644473195_2434900336821488,1,1,0,2,0.6249
1991716644473195_2434910486820473,8,1,0,9,5.0537
1991716644473195_2434943670150488,1,1,0,2,0.5994
1991716644473195_2434970250147830,1,1,0,2,0.5994
1991716644473195_2434974793480709,9,2,0,11,5.6454
1991716644473195_2434975260147329,1,1,0,2,0.6249
1991716644473195_2434987883479400,7,2,0,9,3.5229
1991716644473195_2434988973479291,1,0,0,1,0.4404
1991716644473195_2435005370144318,0,1,0,1,0
1991716644473195_2435007950144060,2,1,0,3,1.0209
1991716644473195_2435034316808090,6,2,0,8,2.8714
1991716644473195_2435064683471720,1,0,0,1,0.5994
1991716644473195_2435261303452058,5,1,0,6,3.1245
1991716644473195_2435326670112188,1,1,0,2,0.4215
1991716644473195_2435327400112115,4,3,0,7,2.3976
1991716644473195_2435341003444088,2,0,0,2,1.1261
1991716644473195_2435379740106881,3,1,0,4,1.7982
1991716644473195_2435380890106766,3,0,0,3,1.6392
1991716644473195_2435383036773218,1,0,0,1,0.4404
1991716644473195_2435386016772920,5,1,0,6,3.4557
1991716644473195_2435424936769028,3,1,0,4,1.56
1991716644473195_2435431653435023,9,0,0,9,5.3631
1991716644473195_2435463563431832,3,0,0,3,1.6915
1991716644473195_2435473413430847,4,1,0,5,2.5345
1991716644473195_2435483903429798,5,2,0,7,2.997
1991716644473195_2435492750095580,2,0,0,2,0.9158
1991716644473195_2435496473428541,1,0,0,1,0.5994
1991716644473195_2435504480094407,1,1,0,2,0.5994
1991716644473195_2435530356758486,2,1,0,3,1.1988
1991716644473195_2435558006755721,2,2,0,4,1.1988
1991716644473195_2435559420088913,2,21,2,25,-0.3957
1991716644473195_2435572143420974,2,1,0,3,1.1988
1991716644473195_2435572996754222,1,0,0,1,0.5994
1991716644473195_2435573713420817,5,1,0,6,3.1882
1991716644473195_2435589133419275,5,0,0,5,2.838
1991716644473195_2435601843418004,2,1,0,3,1.1988
1991716644473195_2435602206751301,1,1,0,2,0.6249
1991716644473195_2435602586751263,3,1,0,4,1.7982
1991716644473195_2435604306751091,6,0,0,6,3.5964
1991716644473195_2435605453417643,9,1,0,10,5.7258
1991716644473195_2435608493417339,4,1,0,5,2.3976
1991716644473195_2435612900083565,3,0,0,3,1.7982
1991716644473195_2435633863414802,3,1,0,4,1.6997
1991716644473195_2435638693414319,2,3,0,5,1.1772
1991716644473195_2435641230080732,1,0,0,1,0.5994
1991716644473195_2435643576747164,8,2,1,11,4.6175
1991716644473195_2435645863413602,1,0,0,1,0.4215
1991716644473195_2435647110080144,0,0,3,3,-1.2057
1991716644473195_2435654910079364,6,2,0,8,3.6408
1991716644473195_2435659600078895,6,0,0,6,3.6893
1991716644473195_2435663880078467,1,0,0,1,0.5473
1991716644473195_2435665663411622,0,2,0,2,0
1991716644473195_2435670193411169,1,1,0,2,0.6249
1991716644473195_2435690603409128,1,1,0,2,0.6249
1991716644473195_2435691176742404,3,0,0,3,1.6392
1991716644473195_2435710373407151,4,1,0,5,1.9461
1991716644473195_2435720790072776,1,1,0,2,0.6249
1991716644473195_2435723700072485,5,2,0,7,2.5206
1991716644473195_2435731010071754,5,0,0,5,2.679
1991716644473195_2435733640071491,1,1,0,2,0.6249
1991716644473195_2435755763402612,2,1,0,3,1.0653
1991716644473195_2435763660068489,1,1,0,2,0.6249
1991716644473195_2435768903401298,3,0,0,3,1.8111
1991716644473195_2435775556733966,4,1,0,5,1.9272
1991716644473195_2435778803400308,2,2,0,4,1.1988
1991716644473195_2435781076733414,0,1,0,1,0
1991716644473195_2435781120066743,3,1,0,4,1.5057
1991716644473195_2435783390066516,7,4,0,11,4.0368
1991716644473195_2435795920065263,3,1,0,4,1.558
1991716644473195_2435816326729889,2,0,0,2,1.3263
1991716644473195_2435821386729383,3,0,0,3,2.1294
1991716644473195_2435822193395969,2,0,0,2,1.1988
1991716644473195_2435835306727991,1,0,0,1,0.4404
1991716644473195_2435839483394240,3,0,0,3,2.1024
1991716644473195_2435841033394085,2,0,0,2,0.8969
1991716644473195_2435843336727188,1,0,0,1,0.5994
1991716644473195_2435843773393811,1,0,0,1,0.5994
1991716644473195_2435848823393306,4,0,0,4,2.0092
1991716644473195_2435854320059423,1,3,1,5,0.3034
1991716644473195_2435875193390669,1,0,0,1,0.5994
1991716644473195_2435903253387863,1,0,0,1,0.5994
1991716644473195_2435903573387831,1,0,0,1,0.5994
1991716644473195_2435956733382515,13,2,0,15,6.758
1991716644473195_2435959240048931,1,0,0,1,0.5994
1991716644473195_2435968076714714,1,0,0,1,0.5994
1991716644473195_2435981776713344,4,0,0,4,2.618
1991716644473195_2435989950045860,1,0,0,1,0.5994
1991716644473195_2435990230045832,4,0,0,4,2.0103
1991716644473195_2436004003377788,3,2,0,5,2.0112
1991716644473195_2436025303375658,3,1,0,4,1.3184
1991716644473195_2436028496708672,2,0,0,2,1.1261
1991716644473195_2436031080041747,1,0,0,1,0.5994
1991716644473195_2436037226707799,2,0,0,2,1.1988
1991716644473195_2436248380020017,1,0,0,1,0.4404
1991716644473195_2436263483351840,21,4,0,25,10.3277
1991716644473195_2436309580013897,4,0,0,4,2.2676
1991716644473195_2436313596680162,7,2,0,9,4.1823
1991716644473195_2436358153342373,1,0,0,1,0.4754
1991716644473195_2436396143338574,6,0,0,6,3.4335
1991716644473195_2436409470003908,1,2,0,3,0.5994
1991716644473195_2436414753336713,2,0,0,2,1.1988
1991716644473195_2436427726668749,2,0,0,2,1.1988
1991716644473195_2436427996668722,1,0,0,1,0.5994
1991716644473195_2436440996667422,1,0,0,1,0.4215
1991716644473195_2436474263330762,3,1,0,4,1.751
1991716644473195_2436492813328907,4,2,0,6,1.7911
1991716644473195_2436496236661898,5,0,0,5,2.867
1991716644473195_2436501369994718,3,0,0,3,1.6007
1991716644473195_2436521499992705,2,0,0,2,0.9854
1991716644473195_2436527286658793,0,0,1,1,-0.296
1991716644473195_2436532276658294,0,1,0,1,0
1991716644473195_2436551916656330,2,0,0,2,1.1261
1991716644473195_2436558723322316,1,3,0,4,0.4404
1991716644473195_2436575296653992,0,1,0,1,0
1991716644473195_2436586243319564,1,0,0,1,0.5994
1991716644473195_2436595329985322,2,1,0,3,1.0123
1991716644473195_2436595809985274,1,0,0,1,0.5994
1991716644473195_2436600533318135,1,0,0,1,0.5994
1991716644473195_2436607389984116,6,1,0,7,3.7875
1991716644473195_2436613266650195,1,0,0,1,0.5267
1991716644473195_2436619263316262,4,0,0,4,2.5632
1991716644473195_2436619769982878,1,0,0,1,0.5994
1991716644473195_2436621593316029,1,0,0,1,0.5994
1991716644473195_2436625723315616,10,0,0,10,5.67
1991716644473195_2436628006648721,0,1,0,1,0
1991716644473195_2436628103315378,5,0,0,5,3.0148
1991716644473195_2436634023314786,1,0,0,1,0.5267
1991716644473195_2436637733314415,1,0,0,1,0.5994
1991716644473195_2436689533309235,7,2,0,9,3.4905
1991716644473195_2436693466642175,1,0,0,1,0.4404
1991716644473195_2436697436641778,0,1,0,1,0
1991716644473195_2436700713308117,1,0,0,1,0.4215
1991716644473195_2436701766641345,1,2,0,3,0.4215
1991716644473195_2436707039974151,2,0,0,2,1.1048
1991716644473195_2436707649974090,1,0,0,1,0.6249
1991716644473195_2436715026640019,1,0,0,1,0.5994
1991716644473195_2436737639971091,3,2,1,6,1.261
1991716644473195_2436738569970998,1,0,0,1,0.7003
1991716644473195_2436745329970322,2,0,0,2,1.1673
1991716644473195_2436756259969229,1,0,0,1,0.4404
1991716644473195_2436763859968469,2,1,0,3,0.7827
1991716644473195_2436764683301720,1,1,1,3,0.0267
1991716644473195_2436767069968148,2,0,0,2,0.9626
1991716644473195_2436772243300964,2,0,0,2,1.1988
1991716644473195_2436773446634177,2,0,0,2,1.3291
1991716644473195_2436776533300535,3,3,1,7,0.9942
1991716644473195_2436781323300056,4,0,0,4,1.8036
1991716644473195_2436797869965068,5,1,0,6,2.237
1991716644473195_2436804543297734,3,0,0,3,1.8237
1991716644473195_2436813403296848,3,2,0,5,1.6105
1991716644473195_2436840503294138,1,2,0,3,0.5994
1991716644473195_2436844769960378,5,0,0,5,3.2778
1991716644473195_2436846273293561,23,2,0,25,11.3445
1991716644473195_2436846636626858,3,0,0,3,1.6203
1991716644473195_2436866709958184,1,0,0,1,0.5994
1991716644473195_2436878726623649,2,0,0,2,0.8619
1991716644473195_2436905036621018,1,0,0,1,0.6908
1991716644473195_2436906183287570,5,0,0,5,2.7153
1991716644473195_2436913193286869,1,0,0,1,0.5994
1991716644473195_2436914519953403,3,0,0,3,1.7982
1991716644473195_2436919619952893,4,3,0,7,2.2195
1991716644473195_2436924169952438,3,0,0,3,1.8989
1991716644473195_2436943639950491,5,1,0,6,2.2579
1991716644473195_2436944549950400,3,0,0,3,1.7255
1991716644473195_2436946176616904,3,0,0,3,1.9638
1991716644473195_2436955559949299,1,0,0,1,0.5994
1991716644473195_2436965373281651,1,0,0,1,0.4404
1991716644473195_2436972343280954,4,0,0,4,2.3976
1991716644473195_2436976033280585,1,0,0,1,0.5994
1991716644473195_2436990256612496,1,0,0,1,0.5994
1991716644473195_2437007919944063,2,0,0,2,1.1988
1991716644473195_2437013299943525,1,0,0,1,0.5994
1991716644473195_2437025663275622,2,0,0,2,1.1988
1991716644473195_2437026723275516,1,1,0,2,0.5994
1991716644473195_2437031149941740,1,0,0,1,0.7269
1991716644473195_2437042246607297,1,0,0,1,0.5994
1991716644473195_2437043439940511,3,2,0,5,1.8349
1991716644473195_2437054839939371,2,0,0,2,1.1988
1991716644473195_2437107119934143,3,0,0,3,1.56
1991716644473195_2437109253267263,1,0,0,1,0.4404
1991716644473195_2437138049931050,2,1,0,3,1.1988
1991716644473195_2437320363246152,0,2,0,2,0
1991716644473195_2437322419912613,5,1,0,6,2.7995
1991716644473195_2437359049908950,1,0,0,1,0.5994
1991716644473195_2437373229907532,1,3,1,5,-0.2188
1991716644473195_2437381656573356,3,0,0,3,1.401
1991716644473195_2437395233238665,5,0,0,5,2.8257
1991716644473195_2437402859904569,1,0,0,1,0.5994
1991716644473195_2437408863237302,1,0,0,1,0.5994
1991716644473195_2437425966568925,2,0,0,2,1.3644
1991716644473195_2437431593235029,3,0,0,3,2.0913
1991716644473195_2437443986567123,7,0,0,7,4.2547
1991716644473195_2437453556566166,9,8,0,17,4.6742
1991716644473195_2437463806565141,5,0,0,5,2.6651
1991716644473195_2437466943231494,0,1,0,1,0
1991716644473195_2437478226563699,1,0,0,1,0.4404
1991716644473195_2437490156562506,1,0,0,1,0.7003
1991716644473195_2437502589894596,6,0,0,6,2.4869
1991716644473195_2437509326560589,1,2,0,3,0.4404
1991716644473195_2437516313226557,2,1,0,3,0.8969
1991716644473195_2437525033225685,3,0,0,3,2.1809
1991716644473195_2437528736558648,1,0,0,1,0.4215
1991716644473195_2437532426558279,6,0,0,6,3.497
1991716644473195_2437537499891105,1,1,0,2,0.7269
1991716644473195_2437537589891096,1,1,0,2,0.3089
1991716644473195_2437542449890610,4,2,0,6,2.0292
1991716644473195_2437543883223800,4,0,0,4,2.5632
1991716644473195_2437547693223419,1,0,0,1,0.5994
1991716644473195_2437554073222781,2,0,0,2,1.1988
1991716644473195_2437556036555918,4,0,0,4,2.5632
1991716644473195_2437562296555292,1,0,0,1,0.5994
1991716644473195_2437573876554134,4,0,0,4,2.0292
1991716644473195_2437576399887215,3,0,0,3,1.7982
1991716644473195_2437580969886758,1,0,0,1,0.5994
1991716644473195_2437592916552230,1,0,0,1,0.4404
1991716644473195_2437592949885560,1,0,0,1,0.4404
1991716644473195_2437605663217622,5,1,0,6,2.385
1991716644473195_2437622039882651,11,3,0,14,6.0196
1991716644473195_2437650583213130,1,0,0,1,0.7841
1991716644473195_2437651713213017,15,2,0,17,10.0679
1991716644473195_2437662229878632,3,0,0,3,2.1294
1991716644473195_2437666559878199,2,0,0,2,1.1988
1991716644473195_2437666589878196,9,4,1,14,4.1817
1991716644473195_2437669733211215,2,0,0,2,1.1988
1991716644473195_2437670226544499,7,0,0,7,4.3614
1991716644473195_2437674979877357,7,2,0,9,3.2412
1991716644473195_2437705373207651,4,0,0,4,2.0867
1991716644473195_2437739969870858,2,0,0,2,1.4219
1991716644473195_2437741693204019,1,0,0,1,0.4404
1991716644473195_2437743646537157,3,1,0,4,1.7982
1991716644473195_2437746579870197,8,0,0,8,4.6118
1991716644473195_2437756359869219,3,0,0,3,2.0677
1991716644473195_2437761246535397,7,0,0,7,4.2507
1991716644473195_2437785206533001,7,3,0,10,4.0953
1991716644473195_2437791919865663,5,0,0,5,2.997
1991716644473195_2437809116530610,3,2,0,5,1.4416
1991716644473195_2437830153195173,3,2,0,5,1.4613
1991716644473195_2437839953194193,2,0,0,2,1.1988
1991716644473195_2437843876527134,4,0,0,4,2.3976
1991716644473195_2437845963193592,4,0,0,4,2.3249
1991716644473195_2437858646525657,1,0,0,1,0.4215
1991716644473195_2437896333188555,1,0,0,1,0.5994
1991716644473195_2437909973187191,2,3,0,5,0.9041
1991716644473195_2437921023186086,5,0,0,5,2.4318
1991716644473195_2437937209851134,6,1,0,7,3.4645
1991716644473195_2437946743183514,1,0,0,1,0.4754
1991716644473195_2437948866516635,0,1,0,1,0
1991716644473195_2437951486516373,6,0,0,6,3.7305
1991716644473195_2437956056515916,1,1,0,2,0.5994
1991716644473195_2437973149847540,9,1,0,10,4.6202
1991716644473195_2437991743179014,1,1,0,2,0.5994
1991716644473195_2438024399842415,2,1,0,3,1.3644
1991716644473195_2438045116507010,2,0,0,2,1.1988
1991716644473195_2438115593166629,2,0,0,2,1.3644
1991716644473195_2438293923148796,3,0,0,3,1.7982
1991716644473195_2438387479806107,1,0,1,2,0.3596
1991716644473195_2438406456470876,4,0,0,4,2.2909
1991716644473195_2438436453134543,1,0,0,1,0.5994
1991716644473195_2438438089801046,7,0,0,7,4.0368
1991716644473195_2438439466467575,3,0,0,3,1.7982
1991716644473195_2438460729798782,2,0,0,2,1.1988
1991716644473195_2438467109798144,2,1,0,3,1.3263
1991716644473195_2438468063131382,2,0,0,2,1.1988
1991716644473195_2438475239797331,4,0,0,4,2.3976
1991716644473195_2438484149796440,4,1,0,5,2.5329
1991716644473195_2438522899792565,6,0,0,6,4.0932
1991716644473195_2438537913124397,3,0,0,3,1.9257
1991716644473195_2438541273124061,1,1,0,2,0.5994
1991716644473195_2438570963121092,2,0,0,2,1.1673
1991716644473195_2438572409787614,6,1,0,7,3.5237
1991716644473195_2438591299785725,3,0,0,3,1.3023
1991716644473195_2438612553116933,3,1,0,4,1.7982
1991716644473195_2438612609783594,4,0,0,4,2.3976
1991716644473195_2438655679779287,2,0,0,2,1.1988
1991716644473195_2438658873112301,1,0,0,1,0.5267
1991716644473195_2438710583107130,2,0,0,2,1.3644
1991716644473195_2438734456438076,5,0,0,5,3.0518
1991716644473195_2438772496434272,1,0,0,1,0.5267
1991716644473195_2438778976433624,1,0,0,1,0.3182
1991716644473195_2438781979766657,2,0,0,2,1.1988
1991716644473195_2438795749765280,8,1,0,9,4.0578
1991716644473195_2438796656431856,2,0,0,2,1.1988
1991716644473195_2438849363093252,6,0,0,6,3.4374
1991716644473195_2438860129758842,6,1,0,7,3.5904
1991716644473195_2438887749756080,6,1,0,7,2.5777
1991716644473195_2438914823086706,2,0,0,2,1.3263
1991716644473195_2438941113084077,2,0,0,2,1.1988
1991716644473195_2438954973082691,10,0,0,10,5.5968
1991716644473195_2438956239749231,3,1,0,4,1.7667
1991716644473195_2438970209747834,16,9,0,25,9.0937
1991716644473195_2438992753078913,1,0,0,1,0.5994
1991716644473195_2439000713078117,2,0,0,2,1.53
1991716644473195_2439017396409782,1,0,0,1,0.7269
1991716644473195_2439029726408549,0,1,0,1,0
1991716644473195_2439044143073774,1,0,0,1,0.765
1991716644473195_2439090539735801,1,1,0,2,0.6588
1991716644473195_2439360406375481,2,0,0,2,0.5746
1991716644473195_2439392739705581,1,0,0,1,0.5994
1991716644473195_2439413633036825,1,0,0,1,0.6249
1991716644473195_2439415303036658,5,0,0,5,2.5998
1991716644473195_2439429423035246,8,0,0,8,5.39
1991716644473195_2439477166363805,1,0,0,1,0.4199
1991716644473195_2439503779694477,0,1,0,1,0
1991716644473195_2439524729692382,1,0,0,1,0.4404
1991716644473195_2439542313023957,6,0,0,6,3.3332
1991716644473195_2439546726356849,13,4,0,17,6.6721
1991716644473195_2439570309687824,3,2,0,5,0.6203
1991716644473195_2439601319684723,2,0,0,2,0.9158
1991716644473195_2439601779684677,3,0,0,3,1.5453
1991716644473195_2439620179682837,1,1,0,2,0.4215
1991716644473195_2439631456348376,1,2,0,3,0.3612
1991716644473195_2439635223014666,7,11,7,25,0.3184
1991716644473195_2439643269680528,1,0,0,1,0.7269
1991716644473195_2439673363010852,6,11,8,25,-0.2785
1991716644473195_2439675819677273,1,0,0,1,0.6249
1991716644473195_2439681016343420,2,0,0,2,1.2513
1991716644473195_2439687359676119,3,0,0,3,1.9464
1991716644473195_2439708469674008,1,0,0,1,0.6908
1991716644473195_2439714526340069,1,0,0,1,0.4215
1991716644473195_2439754053002783,2,0,0,2,1.1983
1991716644473195_2439784692999719,7,3,0,10,3.6475
1991716644473195_2439805312997657,2,1,0,3,0.8969
1991716644473195_2439808652997323,1,0,0,1,0.4215
1991716644473195_2439809829663872,4,1,0,5,2.0292
1991716644473195_2439819112996277,1,0,0,1,0.4927
1991716644473195_2439832742994914,0,2,0,2,0
1991716644473195_2439845356326986,9,8,0,17,4.9094
1991716644473195_2439853932992795,5,1,0,6,2.5569
1991716644473195_2439868049658050,1,0,0,1,0.5244
1991716644473195_2439884096323112,1,0,0,1,0.5994
1991716644473195_2439925259652329,2,0,0,2,1.0398
1991716644473195_2439928432985345,1,6,0,7,0.5994
1991716644473195_2439967782981410,0,2,0,2,0
1991716644473195_2439988196312702,2,0,0,2,1.417
1991716644473195_2440000476311474,1,0,0,1,0.4588
1991716644473195_2440314399613415,0,1,0,1,0
1991716644473195_2440315466279975,1,0,0,1,0.4404
1991716644473195_2440404559604399,1,0,0,1,0.6588
1991716644473195_2440413572936831,1,0,0,1,0.296
1991716644473195_2440425256268996,2,0,0,2,1.0992
1991716644473195_2440439439600911,0,1,0,1,0
1991716644473195_2440456726265849,15,10,0,25,7.9167
1991716644473195_2440460739598781,2,1,0,3,1.1495
1991716644473195_2440520229592832,1,0,0,1,0.4215
1991716644473195_2440533616258160,1,0,0,1,0.5994
1991716644473195_2440536992924489,1,0,0,1,0.4767
1991716644473195_2440548586256663,0,1,0,1,0
1991716644473195_2440569476254574,5,0,0,5,2.7261
1991716644473195_2440593092918879,1,0,0,1,0.6908
1991716644473195_2440612169583638,1,1,0,2,0.4404
1991716644473195_2440614519583403,1,0,0,1,0.4927
1991716644473195_2440630446248477,23,2,0,25,12.2715
1991716644473195_2440635589581296,4,0,0,4,1.862
1991716644473195_2440641479580707,1,0,0,1,0.6588
1991716644473195_2440641806247341,5,0,0,5,2.5347
1991716644473195_2440666639578191,1,0,0,1,0.4404
1991716644473195_2440682962909892,17,3,0,20,8.0086
1991716644473195_2440690992909089,1,0,0,1,0.4754
1991716644473195_2440694346242087,5,3,1,9,2.5003
1991716644473195_2440700076241514,3,0,0,3,1.6917
1991716644473195_2440708476240674,6,1,0,7,3.5476
1991716644473195_2440723829572472,3,0,0,3,1.6392
1991716644473195_2440754029569452,2,0,0,2,0.8808
1991716644473195_2440776526233869,3,1,0,4,1.3562
1991716644473195_2440781646233357,1,0,0,1,0.5859
1991716644473195_2440799979564857,3,0,0,3,1.3912
1991716644473195_2440825519562303,2,1,0,3,0.8808
1991716644473195_2440841586227363,1,2,0,3,0.4404
1991716644473195_2440941076217414,10,0,0,10,4.3015
1991716644473195_2440941872884001,1,0,0,1,0.4927
1991716644473195_2440945976216924,0,1,0,1,0
1991716644473195_2440959369548918,1,0,1,2,0.0477
1991716644473195_2440965639548291,2,0,0,2,1.0209
1991716644473195_2441000199544835,4,0,0,4,1.9811
1991716644473195_2441020266209495,1,0,0,1,0.4927
1991716644473195_2441057512872437,2,0,0,2,0.8619
1991716644473195_2441078829536972,1,0,0,1,0.4215
1991716644473195_2441279942850194,1,0,0,1,0.4404
1991716644473195_2441483482829840,2,0,0,2,1.2023
1991716644473195_2441511499493705,2,1,0,3,1.2391
1991716644473195_2441537776157744,4,0,0,4,2.0793
1991716644473195_2441554586156063,6,1,0,7,3.0671
1991716644473195_2441608136150708,2,0,0,2,1.6085
1991716644473195_2441639162814272,1,0,0,1,0.4215
1991716644473195_2441655976145924,1,0,0,1,0.6249
1991716644473195_2441661269478728,1,0,0,1,0.4404
1991716644473195_2441678142810374,19,6,0,25,9.8446
1991716644473195_2441686432809545,7,7,1,15,2.4499
1991716644473195_2441691882809000,1,0,0,1,0.5994
1991716644473195_2441738329471022,3,1,0,4,1.3562
1991716644473195_2441746589470196,2,0,0,2,0.8808
1991716644473195_2441756092802579,1,0,0,1,0.4404
1991716644473195_2441786549466200,2,0,0,2,1.3644
1991716644473195_2441809279463927,1,0,0,1,0.5994
1991716644473195_2441826382795550,5,15,5,25,0.6902
1991716644473195_2441854536126068,2,0,0,2,0.8726
1991716644473195_2441856276125894,0,3,0,3,0
1991716644473195_2442002622777926,5,0,0,5,2.5219
1991716644473195_2442002936111228,1,1,0,2,0.4927
1991716644473195_2442056539439201,4,0,0,4,2.0642
1991716644473195_2442060912772097,2,0,0,2,1.2196
1991716644473195_2442074809437374,3,0,0,3,1.3023
1991716644473195_2442175829427272,1,0,0,1,0.5859
1991716644473195_2442542486057273,1,1,0,2,0.4404
1991716644473195_2442579722720216,0,1,0,1,0
1991716644473195_2442584302719758,1,0,0,1,0.4215
1991716644473195_2442592902718898,5,0,0,5,2.8579
1991716644473195_2442622026049319,1,0,0,1,0.7269
1991716644473195_2442625369382318,3,0,0,3,1.4802
1991716644473195_2442627929382062,8,2,0,10,4.3625
1991716644473195_2442638899380965,3,1,0,4,1.2151
1991716644473195_2442679056043616,1,0,0,1,0.4215
1991716644473195_2442725539372301,2,0,0,2,0.8808
1991716644473195_2442739062704282,11,0,0,11,5.0417
1991716644473195_2442743462703842,7,0,0,7,3.7316
1991716644473195_2442746416036880,5,4,0,9,2.6359
1991716644473195_2442753789369476,2,0,0,2,1.1003
1991716644473195_2442766306034891,1,1,0,2,0.4215
1991716644473195_2442768066034715,1,0,0,1,0.5994
1991716644473195_2442770602701128,1,0,0,1,0.6249
1991716644473195_2442770886034433,14,1,0,15,7.1
1991716644473195_2442784916033030,2,0,0,2,1.1176
1991716644473195_2442795802698608,4,1,0,5,2.0481
1991716644473195_2442809029363952,3,7,2,12,0.5848
1991716644473195_2442813169363538,2,5,5,12,-2.066
1991716644473195_2442815406029981,0,1,0,1,0
1991716644473195_2442817516029770,0,5,1,6,-0.4019
1991716644473195_2442818716029650,10,1,0,11,4.9756
1991716644473195_2442818779362977,0,10,2,12,-0.592
1991716644473195_2442905736020948,20,2,0,22,10.2921
1991716644473195_2442917136019808,0,1,0,1,0
1991716644473195_2442928622685326,22,3,0,25,13.2535
1991716644473195_2442933232684865,1,1,0,2,0.7269
1991716644473195_2442938976017624,2,0,0,2,0.8808
1991716644473195_2442939952684193,2,2,2,6,0.7598
1991716644473195_2442940582684130,9,2,0,11,4.6827
1991716644473195_2442984459346409,5,5,0,10,2.4874
1991716644473195_2442986606012861,1,0,0,1,0.4404
1991716644473195_2443028426008679,9,2,1,12,3.9605
1991716644473195_2443067236004798,1,0,0,1,0.4404
1991716644473195_2443080546003467,2,0,0,2,0.8619
1991716644473195_2443089529335902,7,0,0,7,3.623
1991716644473195_2443136065997915,8,4,0,12,3.253
1991716644473195_2443198119325043,0,1,0,1,0
1991716644473195_2443499599294895,1,1,0,2,0.7269
1991716644473195_2443506265960895,1,0,0,1,0.4404
1991716644473195_2443531229291732,1,1,0,2,0.4404
1991716644473195_2443542345957287,3,3,0,6,1.7252
1991716644473195_2443563635955158,0,1,0,1,0
1991716644473195_2443570669287788,5,16,4,25,0.3516
1991716644473195_2443609235950598,4,0,0,4,2.1738
1991716644473195_2443689302609258,2,0,0,2,0.8808
1991716644473195_2443696895941832,0,1,0,1,0
1991716644473195_2443697935941728,3,1,0,4,1.3735
1991716644473195_2443712922606896,2,0,0,2,1.2837
1991716644473195_2443735765937945,1,0,0,1,0.4404
1991716644473195_2443790355932486,3,5,2,10,0.4227
1991716644473195_2443804805931041,2,0,0,2,0.9648
1991716644473195_2443805319264323,1,0,0,1,0.6249
1991716644473195_2443844915927030,4,0,0,4,1.7616
1991716644473195_2443858499259005,8,0,0,8,3.9318
1991716644473195_2443869012591287,1,1,0,2,0.4404
1991716644473195_2443900152588173,3,0,0,3,1.3212
1991716644473195_2443906769254178,21,2,0,23,12.4049
1991716644473195_2443959489248906,2,0,0,2,1.0528
1991716644473195_2443961355915386,1,0,0,1,0.4215
1991716644473195_2444042462573942,1,0,0,1,0.4404
1991716644473195_2444052492572939,11,1,0,12,7.1619
1991716644473195_2444060952572093,22,3,0,25,10.6736
1991716644473195_2444064552571733,1,0,0,1,0.4404
1991716644473195_2444090672569121,6,1,0,7,3.0035
1991716644473195_2444129319231923,2,0,0,2,0.8808
1991716644473195_2444518129193042,2,0,0,2,1.0398
1991716644473195_2444518822526306,1,0,0,1,0.4927
1991716644473195_2444520279192827,13,4,0,17,8.3261
1991716644473195_2444548835856638,1,0,0,1,0.5994
1991716644473195_2444568415854680,2,0,0,2,1.1988
1991716644473195_2444572232520965,1,0,0,1,0.6908
1991716644473195_2444572839187571,2,0,0,2,1.1312
1991716644473195_2444576789187176,1,1,0,2,0.5994
1991716644473195_2444579452520243,2,0,0,2,0.843
1991716644473195_2444627122515476,1,0,0,1,0.6249
1991716644473195_2444694399175415,1,3,0,4,0.4404
1991716644473195_2444703309174524,4,0,0,4,1.8828
1991716644473195_2444758069169048,13,0,0,13,6.5316
1991716644473195_2444776105833911,6,0,0,6,2.5888
1991716644473195_2444779392500249,2,3,0,5,1.1988
1991716644473195_2444799512498237,1,0,0,1,0.5994
1991716644473195_2444819002496288,5,3,0,8,2.3097
1991716644473195_2444825382495650,0,1,0,1,0
1991716644473195_2444833245828197,3,0,0,3,1.897
1991716644473195_2444861149158740,1,0,0,1,0.5994
1991716644473195_2445039449140910,23,2,0,25,11.5936
1991716644473195_2445075102470678,1,0,0,1,0.91
1991716644473195_2445113479133507,14,6,1,21,5.3635
1991716644473195_2445165719128283,5,0,0,5,3.1999
1991716644473195_2445473652430823,2,1,0,3,1.1988
1991716644473195_2445506022427586,3,0,0,3,1.7982
1991716644473195_2445623189082536,1,0,0,1,0.6249
1991716644473195_2445740792404109,5,1,0,6,2.081
1991716644473195_2445743145737207,1,0,0,1,0.3818
1991716644473195_2445785389066316,1,1,0,2,0.4927
1991716644473195_2445834959061359,5,1,0,6,2.9243
1991716644473195_2445871519057703,1,1,0,2,0.4215
1991716644473195_2445899229054932,4,2,0,6,1.8669
1991716644473195_2445958829048972,1,0,0,1,0.4754
1991716644473195_2445967239048131,3,0,0,3,1.7982
1991716644473195_2445972602380928,1,0,0,1,0.4754
1991716644473195_2446042565707265,2,1,0,3,1.0398
1991716644473195_2446108972367291,1,0,0,1,0.5994
1991716644473195_2446483712329817,2,0,0,2,1.1988
1991716644473195_2446611568983698,2,0,0,2,1.2391
1991716644473195_2446621685649353,8,0,0,8,4.979
1991716644473195_2446657478979107,1,0,0,1,0.4404
1991716644473195_2446673222310866,10,0,0,10,5.6186
1991716644473195_2446678708976984,4,8,5,17,-0.3801
1991716644473195_2446725925638929,7,0,0,7,4.2522
1991716644473195_2446765142301674,5,0,0,5,2.571
1991716644473195_2446796635631858,13,2,0,15,7.6614
1991716644473195_2446808808963974,4,0,0,4,2.1331
1991716644473195_2446809548963900,3,10,0,13,1.5387
1991716644473195_2446857132292475,7,12,6,25,0.6955
1991716644473195_2446868215624700,1,0,0,1,0.4404
1991716644473195_2446877318957123,2,0,0,2,1.0613
1991716644473195_2446878792290309,1,0,0,1,0.765
1991716644473195_2446899182288270,3,0,0,3,1.3023
1991716644473195_2446928465618675,3,6,2,11,0.4726
1991716644473195_2446934808951374,1,0,0,1,0.4404
1991716644473195_2446955825615939,1,0,0,1,0.5994
1991716644473195_2446960268948828,1,0,0,1,0.5994
1991716644473195_2446979008946954,1,2,0,3,0.6249
1991716644473195_2446990328945822,2,0,0,2,0.8414
1991716644473195_2447025328942322,1,0,0,1,0.4404
1991716644473195_2447037585607763,24,1,0,25,11.406
1991716644473195_2447044115607110,4,0,0,4,1.8894
1991716644473195_2447051388939716,7,0,0,7,3.2827
1991716644473195_2447058315605690,5,4,0,9,2.6774
1991716644473195_2447087072269481,3,0,0,3,1.4471
1991716644473195_2447105235600998,1,0,0,1,0.4404
1991716644473195_2447108215600700,2,0,0,2,1.1673
1991716644473195_2447114472266741,3,0,0,3,1.6203
1991716644473195_2447135428931312,1,0,0,1,0.4215
1991716644473195_2447141852264003,5,0,0,5,3.1482
1991716644473195_2447174388927416,1,1,0,2,0.4754
1991716644473195_2447207202257468,1,0,0,1,0.5267
1991716644473195_2447387418906113,5,1,1,7,2.8495
1991716644473195_2447568048888050,3,1,0,4,1.5888
1991716644473195_2447590492219139,1,1,0,2,0.5994
1991716644473195_2447658932212295,1,0,0,1,0.4404
1991716644473195_2447707078874147,0,2,1,3,-0.2911
1991716644473195_2447728422205346,1,0,0,1,0.5994
1991716644473195_2447739112204277,0,1,0,1,0
1991716644473195_2447758682202320,6,0,0,6,3.9824
1991716644473195_2447813128863542,1,0,0,1,0.4215
1991716644473195_2447851415526380,1,1,0,2,0.4215
1991716644473195_2447852802192908,3,0,0,3,2.0662
1991716644473195_2447856588859196,3,0,0,3,1.3562
1991716644473195_2447862895525232,9,4,0,13,5.2356
1991716644473195_2447873438857511,5,3,0,8,2.3865
1991716644473195_2447890805522441,1,0,0,1,0.6249
1991716644473195_2447907108854144,24,1,0,25,13.3973
1991716644473195_2447909598853895,1,0,0,1,0.6249
1991716644473195_2447923642185824,2,0,0,2,1.1988
1991716644473195_2447968575514664,11,2,0,13,6.7047
1991716644473195_2447989655512556,7,1,0,8,3.9587
1991716644473195_2447994008845454,0,1,0,1,0
1991716644473195_2448016632176525,1,0,0,1,0.9345
1991716644473195_2448016838843171,2,0,0,2,0.5711
1991716644473195_2448039962174192,1,0,0,1,0.5994
1991716644473195_2448051355506386,2,1,0,3,0.8969
1991716644473195_2448057758839079,15,4,0,19,6.9562
1991716644473195_2448076445503877,2,0,0,2,1.0653
1991716644473195_2448098915501630,5,0,0,5,2.2908
1991716644473195_2448110132167175,9,2,0,11,4.2315
1991716644473195_2448205765490945,5,0,0,5,3.3174
1991716644473195_2448234872154701,1,0,0,1,0.7964
1991716644473195_2448236305487891,1,1,0,2,0.0772
1991716644473195_2448239468820908,8,1,0,9,3.8316
1991716644473195_2448251872153001,3,0,0,3,1.5057
1991716644473195_2448255385485983,2,0,0,2,1.1988
1991716644473195_2448271382151050,15,1,0,16,7.1843
1991716644473195_2448283622149826,3,2,0,5,1.6028
1991716644473195_2448284415483080,2,0,0,2,1.1988
1991716644473195_2448377892140399,1,0,0,1,0.6249
1991716644473195_2448470245464497,5,0,0,5,2.4494
1991716644473195_2448849998759855,2,1,0,3,1.3518
1991716644473195_2448857328759122,1,0,0,1,0.4404
1991716644473195_2448865092091679,1,0,0,1,0.8059
1991716644473195_2448955525415969,3,1,0,4,1.7255
1991716644473195_2449089608735894,2,0,0,2,0.9671
1991716644473195_2449225625388959,1,0,0,1,0.6249
1991716644473195_2449259008718954,4,2,0,6,1.9024
1991716644473195_2449302275381294,1,0,0,1,0.3612
1991716644473195_2449316885379833,1,0,0,1,0.4404
1991716644473195_2449345992043589,1,0,0,1,0.4404
1991716644473195_2449374195374102,0,1,0,1,0
1991716644473195_2449386052039583,9,0,0,9,4.3178
1991716644473195_2449390508705804,1,0,0,1,0.4753
1991716644473195_2449396752038513,1,0,0,1,0.5719
1991716644473195_2449407065370815,1,0,0,1,0.7845
1991716644473195_2449411658703689,3,0,0,3,1.5057
1991716644473195_2449420315369490,1,0,0,1,0.4404
1991716644473195_2449431492035039,8,2,0,10,3.8997
1991716644473195_2449431688701686,20,4,1,25,10.3624
1991716644473195_2449433175368204,4,0,0,4,2.6218
1991716644473195_2449468678697987,2,0,0,2,0.8808
1991716644473195_2449500472028141,2,0,0,2,1.1003
1991716644473195_2449540008690854,1,0,0,1,0.5994
1991716644473195_2449566712021517,2,0,0,2,0.9331
1991716644473195_2449572918687563,1,1,0,2,0.9694
1991716644473195_2449724212005767,3,0,0,3,1.6117
1991716644473195_2449969685314553,17,0,0,17,8.1819
1991716644473195_2449999978644857,3,0,0,3,1.4868
1991716644473195_2450019211976267,2,0,0,2,1.0464
1991716644473195_2450027305308791,6,5,0,11,2.529
1991716644473195_2450059918638863,2,0,0,2,1.0653
1991716644473195_2450067568638098,2,2,0,4,0.5699
1991716644473195_2450122961965892,0,1,0,1,0
1991716644473195_2450186768626178,5,0,0,5,2.2543
1991716644473195_2450189055292616,4,0,0,4,1.8473
1991716644473195_2450200575291464,12,2,0,14,6.3114
1991716644473195_2450225245288997,11,1,0,12,5.853
1991716644473195_2450228171955371,1,0,0,1,0.4404
1991716644473195_2450308808613974,3,0,0,3,1.6949
1991716644473195_2450309728613882,2,0,0,2,0.964
1991716644473195_2450309788613876,1,0,0,1,0.4215
1991716644473195_2450312375280284,6,3,0,9,3.3788
1991716644473195_2450370155274506,2,0,0,2,0.8795
1991716644473195_2450409001937288,3,0,0,3,2.0198
1991716644473195_2450464645265057,2,0,0,2,1.5585
1991716644473195_2450476345263887,2,1,0,3,1.4768
1991716644473195_2450509291927259,8,2,0,10,4.8331
1991716644473195_2450550725256449,2,0,0,2,1.0653
1991716644473195_2450682645243257,7,0,0,7,4.2566
1991716644473195_2450969221881266,20,2,0,22,9.6217
1991716644473195_2450983348546520,3,0,0,3,1.5057
1991716644473195_2451036345207887,13,0,0,13,7.3985
1991716644473195_2451152365196285,1,0,0,1,0.7269
1991716644473195_2451178698526985,2,0,0,2,0.8619
1991716644473195_2451241005187421,1,0,0,1,0.4215
1991716644473195_2451247781853410,2,0,0,2,0.8808
1991716644473195_2451267805184741,2,1,0,3,1.5794
1991716644473195_2451268228518032,3,0,0,3,1.519
1991716644473195_2451277015183820,20,2,0,22,12.0197
1991716644473195_2451284865183035,4,0,0,4,2.2568
1991716644473195_2451294758515379,8,2,0,10,4.3103
1991716644473195_2451299428514912,1,0,0,1,0.4215
1991716644473195_2451302821847906,2,0,0,2,1.0653
1991716644473195_2451351341843054,1,0,0,1,0.4215
1991716644473195_2451356978509157,1,0,0,1,0.4215
1991716644473195_2451367345174787,3,0,0,3,1.8747
1991716644473195_2451389221839266,1,0,0,1,0.4215
1991716644473195_2451400261838162,2,0,0,2,0.8808
1991716644473195_2451437671834421,4,0,0,4,2.2352
1991716644473195_2451443551833833,1,0,0,1,0.7316
1991716644473195_2451455301832658,1,0,0,1,0.5994
1991716644473195_2451462725165249,2,1,0,3,1.3128
1991716644473195_2451465111831677,1,0,0,1,0.4404
1991716644473195_2451485001829688,0,2,0,2,0
1991716644473195_2451529495158572,0,1,0,1,0
1991716644473195_2451534708491384,4,0,0,4,2.0673
1991716644473195_2451643258480529,2,0,0,2,1.1823
1991716644473195_2452022718442583,1,1,0,2,0.6249
1991716644473195_2452050475106474,1,0,0,1,0.4215
1991716644473195_2452060118438843,0,1,0,1,0
1991716644473195_2452085571769631,13,10,2,25,4.7836
1991716644473195_2452087698436085,23,2,0,25,11.5092
1991716644473195_2452092138435641,2,0,0,2,0.9331
1991716644473195_2452121658432689,2,0,0,2,1.0773
1991716644473195_2452124978432357,1,0,0,1,0.4215
1991716644473195_2452127705098751,1,1,0,2,0.5994
1991716644473195_2452163295095192,1,0,0,1,0.4215
1991716644473195_2452184058426449,5,0,0,5,2.5143
1991716644473195_2452246765086845,10,3,0,13,5.6087
1991716644473195_2452263728418482,6,2,0,8,2.8682
1991716644473195_2452267955084726,6,0,0,6,3.33
1991716644473195_2452301115081410,2,0,0,2,0.8969
1991716644473195_2452327378412117,5,0,0,5,2.5871
1991716644473195_2452330401745148,1,2,0,3,0.4215
1991716644473195_2452355818409273,1,0,0,1,0.6249
1991716644473195_2452393631738825,17,2,0,19,8.2233
1991716644473195_2452455321732656,1,0,0,1,0.6249
1991716644473195_2452494208395434,2,1,0,3,1.0398
1991716644473195_2452533938391461,1,0,0,1,0.5994
1991716644473195_2452553418389513,2,0,0,2,0.8272
1991716644473195_2452602448384610,3,0,0,3,1.4679
1991716644473195_2452611161717072,4,1,0,5,1.8828
1991716644473195_2452611568383698,2,0,0,2,1.3518
1991716644473195_2452613561716832,1,0,0,1,0.4215
1991716644473195_2452624278382427,5,1,0,6,2.73
1991716644473195_2452628548382000,3,0,0,3,1.5759
1991716644473195_2453240428320812,0,1,0,1,0
1991716644473195_2453275831650605,18,3,0,21,9.7688
1991716644473195_2453278818316973,5,1,0,6,2.4211
1991716644473195_2453579898286865,1,0,0,1,0.6249
1991716644473195_2454097128235142,3,0,0,3,1.5057
1991716644473195_2454110228233832,2,0,0,2,1.0653
1991716644473195_2454153141562874,1,1,1,3,0.483
1991716644473195_2454210628223792,1,1,0,2,0.4215
1991716644473195_2454213764890145,2,0,0,2,1.0653
1991716644473195_2454215244889997,1,0,0,1,0.6249
1991716644473195_2454294791548709,1,1,0,2,0.6249
1991716644473195_2454307781547410,6,0,0,6,2.4358
1991716644473195_2454320481546140,9,2,0,11,3.7254
1991716644473195_2454322084879313,6,1,0,7,3.051
1991716644473195_2454348351543353,2,0,0,2,1.1516
1991716644473195_2454399251538263,2,0,0,2,0.8969
1991716644473195_2454413541536834,18,7,0,25,10.1737
1991716644473195_2454432631534925,2,0,0,2,1.4241
1991716644473195_2454452894866232,0,1,0,1,0
1991716644473195_2454624478182407,9,15,0,24,3.1469
1991716644473195_2454626484848873,2,0,0,2,0.8619
1991716644473195_2454642604847261,1,0,0,1,0.4404
1991716644473195_2454686258176229,4,1,0,5,2.2935
1991716644473195_2454710584840463,3,5,0,8,1.3546
1991716644473195_2454724484839073,0,1,0,1,0
1991716644473195_2454766654834856,1,0,0,1,0.7269
1991716644473195_2454771238167731,3,0,0,3,1.66
1991716644473195_2454813011496887,0,1,0,1,0
1991716644473195_2455102598134595,6,1,0,7,3.5769
1991716644473195_2455111441467044,7,0,0,7,3.3617
1991716644473195_2455167534794768,1,0,0,1,0.4404
1991716644473195_2455195141458674,2,0,0,2,1.1288
1991716644473195_2455205818124273,1,0,0,1,0.4404
1991716644473195_2455227378122117,3,0,0,3,2.628
1991716644473195_2455252368119618,4,0,0,4,2.0334
1991716644473195_2455285851449603,21,4,0,25,10.9898
1991716644473195_2455301254781396,1,0,0,1,0.4404
1991716644473195_2455361054775416,19,3,0,22,10.8321
1991716644473195_2455363921441796,5,5,0,10,2.6584
1991716644473195_2455385238106331,1,3,0,4,0.6249
1991716644473195_2455392464772275,3,0,0,3,1.8271
1991716644473195_2455425524768969,0,1,0,1,0
1991716644473195_2455440598100795,2,0,0,2,1.0653
1991716644473195_2455450168099838,3,0,0,3,1.5057
1991716644473195_2455484581429730,3,2,0,5,1.4679
1991716644473195_2455518714759650,1,3,0,4,0.4404
1991716644473195_2455560254755496,1,0,0,1,0.4215
1991716644473195_2455577301420458,4,0,0,4,1.8488
1991716644473195_2455588271419361,1,0,0,1,0.4754
1991716644473195_2455632571414931,2,2,0,4,1.0464
1991716644473195_2455653104746211,2,0,0,2,0.8808
1991716644473195_2455703604741161,24,1,0,25,14.1651
1991716644473195_2455708068074048,1,0,0,1,0.6249
1991716644473195_2455755471402641,7,16,2,25,1.1187
1991716644473195_2455770311401157,25,0,0,25,12.8859
1991716644473195_2455812104730311,6,2,0,8,3.4311
1991716644473195_2456131264698395,1,1,0,2,0.6249
1991716644473195_2456205141357674,1,0,0,1,0.9049
1991716644473195_2456286921349496,2,1,0,3,1.0653
1991716644473195_2456303784681143,5,0,0,5,2.8925
1991716644473195_2456409858003869,5,1,0,6,2.1184
1991716644473195_2456417458003109,8,0,0,8,4.6434
1991716644473195_2456429628001892,3,1,0,4,1.6512
1991716644473195_2456462057998649,1,0,0,1,0.4215
1991716644473195_2456516521326536,1,0,0,1,0.4927
1991716644473195_2456523677992487,3,0,0,3,1.4085
1991716644473195_2456525264658995,5,2,0,7,2.0609
1991716644473195_2456552241322964,7,1,0,8,3.6715
1991716644473195_2456566077988247,1,0,0,1,0.5994
1991716644473195_2456576164653905,0,3,0,3,0
1991716644473195_2456585464652975,4,0,0,4,1.5829
1991716644473195_2456587084652813,3,1,0,4,1.5407
1991716644473195_2456596927985162,1,1,0,2,0.4215
1991716644473195_2456613807983474,1,0,0,1,0.4754
1991716644473195_2456627624648759,2,0,0,2,0.8808
1991716644473195_2456639167980938,1,0,0,1,0.5244
1991716644473195_2456675427977312,0,1,0,1,0
1991716644473195_2456683034643218,1,0,0,1,0.8481
1991716644473195_2456773007967554,13,9,0,22,7.1805
1991716644473195_2456781291300059,3,0,0,3,1.4892
1991716644473195_2456783684633153,3,0,0,3,1.4868
1991716644473195_2456784201299768,1,0,0,1,0.4404
1991716644473195_2456790611299127,1,0,0,1,0.6249
1991716644473195_2456793657965489,0,1,0,1,0
1991716644473195_2456837507961104,6,0,0,6,3.9276
1991716644473195_2457184844593037,1,1,0,2,0.6249
1991716644473195_2457280044583517,10,2,0,12,5.0352
1991716644473195_2457308711247317,2,1,0,3,0.9934
1991716644473195_2457380191240169,13,10,0,23,5.9737
1991716644473195_2457390381239150,5,0,0,5,2.4663
1991716644473195_2457404087904446,10,1,0,11,4.1376
1991716644473195_2457425267902328,3,0,0,3,1.3018
1991716644473195_2457438294567692,2,1,0,3,1.0464
1991716644473195_2457462094565312,7,3,0,10,3.2106
1991716644473195_2457462267898628,8,1,0,9,3.5043
1991716644473195_2457464417898413,25,0,0,25,13.6096
1991716644473195_2457466081231580,8,1,0,9,3.4854
1991716644473195_2457469417897913,2,0,0,2,0.8619
1991716644473195_2457485527896302,0,1,0,1,0
1991716644473195_2457502717894583,0,2,1,3,-0.296
1991716644473195_2457511244560397,1,0,0,1,0.8531
1991716644473195_2457511261227062,21,1,0,22,12.8605
1991716644473195_2457521607892694,1,0,0,1,0.6249
1991716644473195_2457607141217474,7,4,0,11,4.4017
1991716644473195_2457615817883273,1,0,0,1,0.4215
1991716644473195_2457629037881951,6,6,2,14,1.868
1991716644473195_2457647447880110,0,0,1,1,-0.5255
1991716644473195_2457647741213414,5,1,0,6,3.2142
1991716644473195_2457694811208707,2,0,0,2,0.8808
1991716644473195_2457695764541945,6,0,0,6,2.6585
1991716644473195_2457696284541893,23,2,0,25,14.325
1991716644473195_2457696824541839,15,1,0,16,6.9883
1991716644473195_2457699304541591,1,0,0,1,0.4404
1991716644473195_2457699601208228,6,1,0,7,2.8414
1991716644473195_2457702601207928,20,5,0,25,11.0025
1991716644473195_2457726361205552,5,2,0,7,2.6801
1991716644473195_2457767181201470,15,10,0,25,8.7942
1991716644473195_2457773631200825,8,2,0,10,4.0625
1991716644473195_2457774607867394,2,0,0,2,1.0653
1991716644473195_2457784401199748,2,1,0,3,1.0263
1991716644473195_2457797047865150,5,1,0,6,2.1453
1991716644473195_2457807774530744,1,0,0,1,0.4215
1991716644473195_2457867781191410,1,1,0,2,0.6249
1991716644473195_2457896321188556,2,1,0,3,1.3263
1991716644473195_2458220061156182,0,1,0,1,0
1991716644473195_2458310167813838,2,0,0,2,1.5746
1991716644473195_2458428451135343,1,0,0,1,0.4404
1991716644473195_2458444954467026,2,0,0,2,1.0123
1991716644473195_2458516287793226,4,1,0,5,2.0857
1991716644473195_2458523517792503,2,0,0,2,1.2629
1991716644473195_2458545277790327,1,0,0,1,0.4215
1991716644473195_2458590947785760,1,0,0,1,0.4215
1991716644473195_2458612141116974,1,0,0,1,0.7184
1991716644473195_2458624894449032,0,1,0,1,0
1991716644473195_2458632617781593,3,0,0,3,1.4917
1991716644473195_2458644351113753,1,1,0,2,0.5994
1991716644473195_2458663701111818,3,2,0,5,1.886
1991716644473195_2458674081110780,2,0,0,2,0.7827
1991716644473195_2458723741105814,1,0,0,1,0.5994
1991716644473195_2458745247770330,2,0,0,2,1.0464
1991716644473195_2458759434435578,2,1,0,3,1.2243
1991716644473195_2458774831100705,1,0,0,1,0.4215
1991716644473195_2458885201089668,1,1,0,2,0.4404
1991716644473195_2458955707749284,2,0,0,2,0.8969
1991716644473195_2459259177718937,9,1,0,10,5.1202
1991716644473195_2459283231049865,2,3,0,5,1.2591
1991716644473195_2459325457712309,2,0,0,2,1.8987
1991716644473195_2459333807711474,1,1,0,2,0.5994
1991716644473195_2459346244376897,8,2,0,10,4.648
1991716644473195_2459370234374498,6,0,0,6,3.5607
1991716644473195_2459374397707415,1,0,0,1,0.4404
1991716644473195_2459405514370970,3,0,0,3,1.3373
1991716644473195_2459411367703718,2,0,0,2,1.0464
1991716644473195_2459412804370241,6,1,0,7,2.6513
1991716644473195_2459448001033388,8,0,0,8,4.0069
1991716644473195_2459494394362082,1,0,0,1,0.4404
1991716644473195_2459495747695280,1,0,0,1,0.6249
1991716644473195_2459505671027621,2,0,0,2,1.1865
1991716644473195_2459507967694058,9,1,0,10,5.2087
1991716644473195_2459527497692105,3,0,0,3,1.2231
1991716644473195_2459536867691168,2,0,0,2,0.8808
1991716644473195_2459559094355612,1,0,0,1,0.963
1991716644473195_2459577931020395,0,1,0,1,0
1991716644473195_2459582481019940,1,0,0,1,0.4215
1991716644473195_2459625347682320,2,0,0,2,0.8619
1991716644473195_2459769601001228,7,4,0,11,3.7986
1991716644473195_2459825744328947,14,9,0,23,8.6847
1991716644473195_2459826514328870,6,8,1,15,3.454
1991716644473195_2459826784328843,2,2,0,4,1.3798
1991716644473195_2459827070995481,1,0,0,1,0.6249
1991716644473195_2459827234328798,3,4,0,7,1.7982
1991716644473195_2459886057656249,0,1,0,1,0
1991716644473195_2459910600987128,1,0,0,1,0.4215
1991716644473195_2459984837646371,3,0,0,3,1.3562
1991716644473195_2460019164309605,1,0,0,1,0.4215
1991716644473195_2460045607640294,2,0,0,2,1.1673
1991716644473195_2460481877596667,2,0,0,2,1.4127
1991716644473195_2460613820916806,1,0,0,1,0.4215
1991716644473195_2460720677572787,8,3,0,11,4.1149
1991716644473195_2460877524223769,3,0,0,3,1.4613
1991716644473195_2460952824216239,3,0,0,3,1.7922
1991716644473195_2461016400876548,3,0,0,3,1.8418
1991716644473195_2461599664151555,2,0,0,2,1.0653
1991716644473195_2461668190811369,1,0,0,1,0.6249
1991716644473195_2461709060807282,4,0,0,4,2.1051
1991716644473195_2461728617471993,2,0,0,2,0.843
1991716644473195_2461789000799288,1,0,0,1,0.5719
1991716644473195_2461848237460031,4,1,0,5,1.8194
1991716644473195_2461874027457452,3,0,0,3,1.4988
1991716644473195_2461919754119546,4,1,0,5,2.0654
1991716644473195_2461920757452779,1,1,0,2,0.6249
1991716644473195_2461921104119411,7,2,0,9,3.7546
1991716644473195_2461921344119387,3,0,0,3,1.7922
1991716644473195_2461921567452698,7,0,0,7,3.516
1991716644473195_2461922167452638,3,5,0,8,1.6392
1991716644473195_2461923167452538,19,3,0,22,9.6578
1991716644473195_2461923334119188,11,4,0,15,6.3235
1991716644473195_2461923440785844,3,0,0,3,1.9809
1991716644473195_2461971417447713,0,1,0,1,0
1991716644473195_2461993747445480,6,1,0,7,3.0783
1991716644473195_2461997804111741,1,0,0,1,0.4215
1991716644473195_2462009760777212,0,1,0,1,0
1991716644473195_2462045007440354,6,0,0,6,3.1383
1991716644473195_2462049347439920,1,4,0,5,0.34
1991716644473195_2462065487438306,11,0,0,11,5.6586
1991716644473195_2462107060767482,2,0,0,2,0.9681
1991716644473195_2462125927432262,0,1,0,1,0
1991716644473195_2462130277431827,4,0,0,4,2.1041
1991716644473195_2462174307427424,21,4,0,25,11.548
1991716644473195_2462667304044791,1,0,0,1,0.4404
1991716644473195_2462680874043434,23,2,0,25,12.1365
1991716644473195_2462681627376692,2,0,0,2,0.8808
1991716644473195_2462699044041617,10,2,0,12,5.2585
1991716644473195_2462816167363238,1,0,0,1,0.6908
1991716644473195_2463103657334489,1,0,0,1,0.4927
1991716644473195_2463151667329688,1,0,0,1,0.4927
1991716644473195_2463272453984276,2,0,0,2,0.8619
1991716644473195_2463713370606851,7,17,0,24,1.9653
1991716644473195_2463760003935521,3,0,0,3,1.2834
1991716644473195_2463922943919227,1,0,0,1,0.4404
1991716644473195_2464061463905375,1,0,0,1,0.4215
1991716644473195_2464243387220516,1,1,0,2,0.4404
1991716644473195_2464284423883079,5,0,0,5,2.4026
1991716644473195_2464599050518283,1,0,0,1,0.4215
1991716644473195_2464783640499824,7,0,0,7,4.0323
1991716644473195_2464836677161187,25,0,0,25,12.5854
1991716644473195_2464837163827805,2,1,0,3,1.1003
1991716644473195_2464882587156596,2,0,0,2,1.3252
1991716644473195_2464897247155130,5,0,0,5,2.7071
1991716644473195_2464915993819922,7,0,0,7,3.4597
1991716644473195_2464988030479385,8,4,1,13,4.304
1991716644473195_2465033963808125,1,0,0,1,0.2382
1991716644473195_2465197970458391,7,0,0,7,3.5391
1991716644473195_2465206633790858,4,1,0,5,2.1311
1991716644473195_2465206970457491,1,0,0,1,0.6249
1991716644473195_2465212957123559,2,0,0,2,1.0653
1991716644473195_2465222893789232,2,1,0,3,1.0653
1991716644473195_2465271360451052,23,0,0,23,12.1867
1991716644473195_2465721583739363,9,2,0,11,4.9766
1991716644473195_2465723973739124,0,4,0,4,0
1991716644473195_2465826317062223,1,0,0,1,0.4404
1991716644473195_2465951560383032,2,1,0,3,1.2618
1991716644473195_2465990887045766,3,0,0,3,1.4868
1991716644473195_2466021433709378,8,1,0,9,4.6246
1991716644473195_2466022323709289,1,1,0,2,0.7269
1991716644473195_2466022923709229,1,0,0,1,0.4404
1991716644473195_2466025793708942,20,4,0,24,10.2943
1991716644473195_2466121383699383,1,0,0,1,0.4215
1991716644473195_2466153880362800,9,1,0,10,4.9684
1991716644473195_2466170957027759,1,1,0,2,0.765
1991716644473195_2466182170359971,6,0,0,6,3.1959
1991716644473195_2466199967024858,2,1,0,3,0.843
1991716644473195_2466490373662484,21,4,0,25,10.4518
1991716644473195_2466493693662152,2,0,0,2,0.8619
1991716644473195_2466493923662129,2,0,0,2,0.8016
1991716644473195_2466531963658325,2,0,0,2,1.0464
1991716644473195_2466543803657141,2,1,0,3,0.9854
1991716644473195_2466571993654322,1,0,0,1,0.9055
1991716644473195_2466578266987028,13,5,0,18,6.8793
1991716644473195_2466643660313822,1,0,0,1,0.4404
1991716644473195_2466655456979309,0,2,0,2,0
1991716644473195_2466666316978223,4,5,2,11,1.2068
1991716644473195_2466767196968135,1,0,0,1,0.4404
1991716644473195_2466818290296359,3,0,0,3,2.0674
1991716644473195_2466894760288712,4,0,0,4,2.1117
1991716644473195_2466906213620900,1,0,0,1,0.5244
1991716644473195_2466950280283160,8,6,0,14,3.76
1991716644473195_2466961033615418,3,0,0,3,1.3023
1991716644473195_2466995883611933,2,0,0,2,0.9158
1991716644473195_2467007806944074,8,1,1,10,3.6058
1991716644473195_2467550873556434,18,6,1,25,10.7656
1991716644473195_2467657176879137,4,0,0,4,2.0796
1991716644473195_2467879776856877,0,2,0,2,0
1991716644473195_2468138516831003,5,0,1,6,1.9613
1991716644473195_2468230556821799,0,1,0,1,0
1991716644473195_2468236923487829,6,1,0,7,2.5392
1991716644473195_2468292640148924,4,0,0,4,1.795
1991716644473195_2468305230147665,2,0,0,2,1.0653
1991716644473195_2468312243480297,3,0,0,3,1.7561
1991716644473195_2468422210135967,1,0,0,1,0.6249
1991716644473195_2468515736793281,4,0,0,4,1.9454
1991716644473195_2468635270114661,5,1,0,6,2.6224
1991716644473195_2468920106752844,1,0,0,1,0.4404
1991716644473195_2468950823416439,10,1,0,11,4.6407
1991716644473195_2468952456749609,4,1,0,5,2.1995
1991716644473195_2469171680061020,17,2,0,19,8.9051
1991716644473195_2469245463386975,1,0,0,1,0.4215
1991716644473195_2469246323386889,1,0,0,1,0.0772
1991716644473195_2469289720049216,1,0,0,1,0.6249
1991716644473195_2469800353331486,6,0,0,6,2.8665
1991716644473195_2470019903309531,1,0,0,1,0.4215
1991716644473195_2470051059973082,1,0,0,1,0.6249
1991716644473195_2470059686638886,2,0,0,2,0.8619
1991716644473195_2470108196634035,7,2,0,9,3.7586
1991716644473195_2470120013299520,1,0,0,1,0.5972
1991716644473195_2470216169956571,1,0,0,1,0.6249
1991716644473195_2470488069929381,8,2,0,10,4.0048
1991716644473195_2470570149921173,6,0,0,6,2.5905
1991716644473195_2470584693253052,1,0,0,1,0.4939
1991716644473195_2470595179918670,2,0,0,2,1.0263
1991716644473195_2470669296577925,8,1,0,9,3.4854
1991716644473195_2470675216577333,5,1,0,6,2.5991
1991716644473195_2470677749910413,2,1,0,3,1.0464
1991716644473195_2470695746575280,23,2,0,25,12.7231
1991716644473195_2470705433240978,2,0,0,2,0.843
1991716644473195_2470733603238161,1,0,0,1,0.6249
1991716644473195_2470735396571315,1,1,0,2,0.4404
1991716644473195_2470779776566877,1,0,0,1,0.4215
1991716644473195_2470805026564352,1,0,0,1,0.6908
1991716644473195_2470859603225561,6,4,0,10,3.1421
1991716644473195_2470877233223798,6,5,0,11,3.6802
1991716644473195_2470897369888451,21,3,1,25,10.1287
1991716644473195_2470920826552772,2,0,0,2,0.8808
1991716644473195_2470948949883293,4,0,0,4,2.4413
1991716644473195_2470973559880832,6,0,0,6,3.2335
1991716644473195_2471004813211040,1,8,0,9,0.6249
1991716644473195_2471012869876901,0,1,0,1,0
1991716644473195_2471040603207461,1,0,0,1,0.6249
1991716644473195_2471044553207066,1,0,0,1,0.6249
1991716644473195_2471366689841519,1,0,0,1,0.6249
1991716644473195_2471378963173625,2,0,0,2,1.2536
1991716644473195_2471394739838714,3,1,0,4,1.3747
1991716644473195_2471420236502831,4,0,0,4,2.2428
1991716644473195_2471441493167372,2,0,0,2,1.1484
1991716644473195_2471442593167262,1,1,0,2,0.4754
1991716644473195_2471488989829289,2,0,0,2,1.2498
1991716644473195_2471507143160807,1,0,0,1,0.4215
1991716644473195_2471570463154475,2,0,0,2,0.8619
1991716644473195_2471597979818390,0,1,0,1,0
1991716644473195_2471600236484831,7,1,0,8,3.045
1991716644473195_2471603763151145,1,0,0,1,0.4754
1991716644473195_2471674699810718,5,1,0,6,1.1576
1991716644473195_2471675006477354,12,5,0,17,4.9436
1991716644473195_2471714146473440,1,0,0,1,0.4404
1991716644473195_2471790756465779,1,0,0,1,0.4404
1991716644473195_2471815666463288,2,0,0,2,0.8969
1991716644473195_2471829363128585,5,0,0,5,2.8067
1991716644473195_2472274349750753,11,13,1,25,2.6291
1991716644473195_2472325853078936,0,1,0,1,0
1991716644473195_2472343259743862,4,1,0,5,2.3233
1991716644473195_2472352046409650,1,0,0,1,0.6249
1991716644473195_2472360706408784,6,0,0,6,2.8723
1991716644473195_2472545476390307,1,0,0,1,0.5994
1991716644473195_2472586366386218,8,6,0,14,4.1368
1991716644473195_2472790463032475,1,1,0,2,0.4404
1991716644473195_2472903739687814,1,0,0,1,0.5719
1991716644473195_2473243122987209,3,2,0,5,1.6642
1991716644473195_2473264709651717,1,0,0,1,0.4215
1991716644473195_2473267572984764,1,0,0,1,0.4215
1991716644473195_2473271749651013,4,0,0,4,1.7427
1991716644473195_2473280342983487,1,1,0,2,0.2732
1991716644473195_2473301572981364,1,0,0,1,0.4215
1991716644473195_2473307962980725,3,0,0,3,2.4419
1991716644473195_2473308689647319,3,0,0,3,1.4802
1991716644473195_2473340896310765,1,0,0,1,0.4404
1991716644473195_2473343342977187,1,0,0,1,0.5994
1991716644473195_2473348029643385,1,1,0,2,0.5994
1991716644473195_2473362496308605,1,0,0,1,0.4404
1991716644473195_2473375746307280,1,2,0,3,0.6361
1991716644473195_2473376462973875,1,0,0,1,0.4215
1991716644473195_2473381646306690,5,1,0,6,1.9138
1991716644473195_2473400346304820,8,4,0,12,4.0881
1991716644473195_2473462366298618,1,0,0,1,0.4404
1991716644473195_2473532989624889,3,0,0,3,2.2898
1991716644473195_2473534142958107,3,2,0,5,1.9952
1991716644473195_2473553049622883,16,5,0,21,7.6226
1991716644473195_2473604929617695,0,1,0,1,0
1991716644473195_2473626236282231,2,0,0,2,0.8808
1991716644473195_2473633719614816,2,0,0,2,1.1003
1991716644473195_2473662399611948,9,2,0,11,3.9942
1991716644473195_2473912332920288,19,6,0,25,9.6836
1991716644473195_2474021889575999,1,0,0,1,0.8176
1991716644473195_2474032386241616,1,0,0,1,0.4215
1991716644473195_2474063276238527,10,8,0,18,5.9198
1991716644473195_2474080709570117,13,1,0,14,6.87
1991716644473195_2474164386228416,1,0,0,1,0.4404
1991716644473195_2474194342892087,2,0,0,2,1.0209
1991716644473195_2474215559556632,1,0,0,1,0.8625
1991716644473195_2474222799555908,1,0,0,1,0.3612
1991716644473195_2474232062888315,6,1,0,7,3.3574
1991716644473195_2474279522883569,3,0,0,3,1.4424
1991716644473195_2474302776214577,3,1,0,4,1.6392
1991716644473195_2474331282878393,1,0,0,1,0.4215
1991716644473195_2474336306211224,1,0,0,1,0.8442
1991716644473195_2474350599543128,6,3,0,9,3.2904
1991716644473195_2474360066208848,10,1,0,11,6.23
1991716644473195_2474366916208163,2,0,0,2,1.535
1991716644473195_2474428956201959,9,0,0,9,4.5703
1991716644473195_2474452152866306,1,1,0,2,0.4939
1991716644473195_2474501349528053,15,5,0,20,9.4299
1991716644473195_2474522782859243,3,2,0,5,1.3023
1991716644473195_2474756379502550,8,2,0,10,4.3127
1991716644473195_2474790639499124,5,1,0,6,2.1826
1991716644473195_2474791686165686,22,3,0,25,12.3907
1991716644473195_2474805856164269,5,2,0,7,2.3472
1991716644473195_2474816939496494,1,0,0,1,0.4404
1991716644473195_2474828306162024,3,0,0,3,1.9937
1991716644473195_2474856259492562,2,0,0,2,1.0209
1991716644473195_2474868662824655,1,0,0,1,0.4215
1991716644473195_2474875242823997,5,1,0,6,2.3676
1991716644473195_2474875506157304,3,0,0,3,1.7773
1991716644473195_2474875869490601,1,0,0,1,0.4019
1991716644473195_2474899629488225,0,1,0,1,0
1991716644473195_2474901036154751,4,1,0,5,2.2454
1991716644473195_2474902642821257,1,0,0,1,0.4215
1991716644473195_2474964479481740,1,0,0,1,0.8442
1991716644473195_2474972466147608,1,0,0,1,0.4754
1991716644473195_2474980739480114,6,0,0,6,3.4983
1991716644473195_2474982796146575,3,0,0,3,1.154
1991716644473195_2474990226145832,15,10,0,25,8.0185
1991716644473195_2474999769478211,0,3,0,3,0
1991716644473195_2475012476143607,2,0,0,2,1.0209
1991716644473195_2475023522809169,0,2,1,3,-0.3412
1991716644473195_2475036142807907,0,1,0,1,0
1991716644473195_2475047682806753,1,0,0,1,0.5994
1991716644473195_2475061209472067,1,1,0,2,0.9451
1991716644473195_2475064699471718,7,4,0,11,4.3883
1991716644473195_2475066972804824,3,0,0,3,1.3473
1991716644473195_2475084392803082,6,1,0,7,2.9001
1991716644473195_2475097482801773,2,0,0,2,1.1988
1991716644473195_2475114386133416,1,0,0,1,0.4404
1991716644473195_2475115226133332,1,1,0,2,0.4404
1991716644473195_2475116016133253,0,1,0,1,0
1991716644473195_2475137366131118,2,0,0,2,0.843
1991716644473195_2475142252797296,18,7,0,25,11.1121
1991716644473195_2475160179462170,1,1,0,2,0.4404
1991716644473195_2475163346128520,4,1,0,5,2.1048
1991716644473195_2475181596126695,1,0,0,1,0.4754
1991716644473195_2475188012792720,4,0,0,4,2.3479
1991716644473195_2475188769459311,4,0,0,4,2.3801
1991716644473195_2475264766118378,1,0,0,1,0.4404
1991716644473195_2475308682780653,14,2,0,16,7.9006
1991716644473195_2475560126088842,4,0,0,4,1.9868
1991716644473195_2475712456073609,6,2,0,8,3.8161
1991716644473195_2475717736073081,1,0,0,1,0.4199
1991716644473195_2475737772737744,3,0,0,3,0.958
1991716644473195_2475815636063291,2,1,0,3,0.9331
1991716644473195_2475817252729796,2,0,0,2,0.8808
1991716644473195_2475851652726356,4,1,1,6,1.31
1991716644473195_2475874939390694,2,0,0,2,0.9606
1991716644473195_2475888409389347,0,1,0,1,0
1991716644473195_2475937899384398,4,2,0,6,1.8078
1991716644473195_2475944352717086,1,0,0,1,0.4404
1991716644473195_2475970299381158,1,0,0,1,0.4215
1991716644473195_2475982182713303,1,2,0,3,0.4754
1991716644473195_2475987566046098,1,0,0,1,0.4404
1991716644473195_2476056386039216,1,0,0,1,0.4404
1991716644473195_2476065152705006,3,0,0,3,1.5057
1991716644473195_2476077882703733,21,4,0,25,11.1192
1991716644473195_2476094232702098,1,0,0,1,0.9081
1991716644473195_2476103879367800,2,0,0,2,1.725
1991716644473195_2476133746031480,3,0,0,3,1.6303
1991716644473195_2476146646030190,1,0,0,1,0.3612
1991716644473195_2476171319361056,8,1,0,9,4.7136
1991716644473195_2476458099332378,5,1,0,6,2.9176
1991716644473195_2476483052663216,7,6,0,13,3.3121
1991716644473195_2476554795989375,0,1,0,1,0
1991716644473195_2476600799318108,3,0,0,3,1.996
1991716644473195_2476610122650509,1,0,0,1,0.4404
1991716644473195_2476668182644703,2,0,0,2,0.843
1991716644473195_2476736369304551,7,0,0,7,3.1118
1991716644473195_2476745199303668,2,1,0,3,1.2778
1991716644473195_2476750652636456,2,0,0,2,0.9648
1991716644473195_2476790719299116,1,0,0,1,0.4404
1991716644473195_2476804082631113,2,1,0,3,0.8969
1991716644473195_2476844089293779,20,3,0,23,9.8239
1991716644473195_2476850925959762,2,0,0,2,0.8969
1991716644473195_2477205879257600,2,0,0,2,0.9934
1991716644473195_2477279049250283,2,0,0,2,1.3848
1991716644473195_2477355432575978,4,0,0,4,2.3916
1991716644473195_2477361519242036,5,0,0,5,2.2979
1991716644473195_2477388775905977,1,0,0,1,0.4939
1991716644473195_2477399682571553,2,0,0,2,0.843
1991716644473195_2477412095903645,1,2,0,3,0.0772
1991716644473195_2477432695901585,2,3,0,5,0.8619
1991716644473195_2477433435901511,3,0,0,3,1.3023
1991716644473195_2477444259233762,8,0,0,8,4.5833
1991716644473195_2477470219231166,3,3,0,6,1.8659
1991716644473195_2477476569230531,0,2,0,2,0
1991716644473195_2477476959230492,9,2,0,11,3.9055
1991716644473195_2477480382563483,1,0,0,1,0.4215
1991716644473195_2477512522560269,1,1,0,2,0.4754
1991716644473195_2477541255890729,1,1,0,2,0.5994
1991716644473195_2477545052557016,3,1,0,4,1.5806
1991716644473195_2477551969222991,1,0,0,1,0.7397
1991716644473195_2477660005878854,3,1,0,4,1.8046
1991716644473195_2477670895877765,12,1,0,13,5.8521
1991716644473195_2477681979209990,2,1,0,3,1.191
1991716644473195_2477714692540052,1,0,0,1,0.7334
1991716644473195_2477731709205017,5,1,0,6,2.4738
1991716644473195_2478121625832692,6,1,0,7,3.611
1991716644473195_2478147572496764,1,1,0,2,0.3612
1991716644473195_2478149242496597,3,0,0,3,1.3212
1991716644473195_2478155582495963,2,4,0,6,1.3958
1991716644473195_2478177885827066,7,1,0,8,3.6569
1991716644473195_2478196359158552,1,0,0,1,0.4404
1991716644473195_2478212359156952,0,1,0,1,0
1991716644473195_2478222465822608,1,0,0,1,0.4215
1991716644473195_2478225039155684,0,1,0,1,0
1991716644473195_2478233389154849,2,0,0,2,1.0653
1991716644473195_2478247575820097,7,2,0,9,3.1967
1991716644473195_2478262969151891,2,7,0,9,1.0653
1991716644473195_2478273395817515,14,0,0,14,7.5493
1991716644473195_2478291452482376,1,0,0,1,0.5994
1991716644473195_2478332885811566,2,0,0,2,1.0653
1991716644473195_2478355759142612,7,1,0,8,3.8305
1991716644473195_2478385282472993,5,1,0,6,2.4026
1991716644473195_2478410269137161,1,0,0,1,0.4404
1991716644473195_2478430612468460,1,0,0,1,0.4404
1991716644473195_2478475319130656,3,1,0,4,1.505
1991716644473195_2478500849128103,5,0,0,5,3.1375
1991716644473195_2478514835793371,6,1,0,7,4.2184
1991716644473195_2478564112455110,1,0,0,1,0.4404
1991716644473195_2478645655780289,4,0,0,4,1.8544
1991716644473195_2478952359082952,4,0,0,4,2.7016
1991716644473195_2479027059075482,1,0,0,1,0.8679
1991716644473195_2479125355732319,21,4,0,25,10.4989
1991716644473195_2479128012398720,1,0,0,1,0.2732
1991716644473195_2479157385729116,1,4,0,5,0.4404
1991716644473195_2479327472378774,17,7,0,24,9.0212
1991716644473195_2479334719044716,1,0,0,1,0.4404
1991716644473195_2479365655708289,3,1,0,4,1.519
1991716644473195_2480001262311395,11,2,0,13,5.358
1991716644473195_2480023142309207,2,0,0,2,0.9158
1991716644473195_2480048565639998,1,1,0,2,0.7003
1991716644473195_2480109012300620,16,8,0,24,7.9849
1991716644473195_2480117808966407,3,0,0,3,1.2834
1991716644473195_2480120672299454,11,6,3,20,3.5006
1991716644473195_2480122965632558,20,5,0,25,10.4704
1991716644473195_2480143725630482,1,0,0,1,0.5994
1991716644473195_2480150642296457,1,0,0,1,0.8059
1991716644473195_2480161198962068,3,2,0,5,1.8577
1991716644473195_2480242948953893,1,0,0,1,0.4754
1991716644473195_2480302425614612,2,1,0,3,1.0653
1991716644473195_2480313925613462,24,1,0,25,13.8254
1991716644473195_2480351218943066,8,2,0,10,4.2823
1991716644473195_2480373755607479,1,0,0,1,0.8799
1991716644473195_2480392448938943,18,1,0,19,9.5547
1991716644473195_2480625585582296,5,2,0,7,2.9574
1991716644473195_2480681198910068,1,0,0,1,0.4927
1991716644473195_2480726212238900,2,0,0,2,0.9158
1991716644473195_2480736815571173,2,0,0,2,0.9158
1991716644473195_2480737892237732,2,0,0,2,1.2243
1991716644473195_2480790182232503,6,5,0,11,3.6168
1991716644473195_2480808665563988,4,0,0,4,1.8139
1991716644473195_2480816772229844,3,0,1,4,1.027
1991716644473195_2480827955562059,8,1,0,9,4.0538
1991716644473195_2480862608891927,0,1,0,1,0
1991716644473195_2480872625557592,2,0,0,2,0.8808
1991716644473195_2480875142224007,7,0,0,7,3.1946
1991716644473195_2480883018889886,2,3,0,5,0.9331
1991716644473195_2480890242222497,17,5,0,22,7.5108
1991716644473195_2480914792220042,1,0,0,1,0.4754
1991716644473195_2480924902219031,1,0,0,1,0.6588
1991716644473195_2480952715549583,1,0,0,1,0.6361
1991716644473195_2480956652215856,2,0,0,2,0.9331
1991716644473195_2480964098881778,4,21,0,25,2.4278
1991716644473195_2480967148881473,9,2,0,11,5.3372
1991716644473195_2480992668878921,2,1,0,3,1.0653
1991716644473195_2481015918876596,1,3,0,4,0.6597
1991716644473195_2481025508875637,1,0,0,1,0.6249
1991716644473195_2481029805541874,2,1,0,3,0.8619
1991716644473195_2481068792204642,13,1,0,14,6.6732
1991716644473195_2481112298866958,2,0,0,2,0.8619
1991716644473195_2481207115524143,6,4,0,10,3.3047
1991716644473195_2481404835504371,1,0,0,1,0.4404
1991716644473195_2481420445502810,5,1,0,6,2.2531
1991716644473195_2481532288824959,9,5,0,14,4.7529
1991716644473195_2481549982156523,2,2,0,4,1.2957
1991716644473195_2481550588823129,0,0,2,2,-0.4739
1991716644473195_2481630205481834,14,11,0,25,4.745
1991716644473195_2481634478814740,1,3,0,4,0.4215
1991716644473195_2481649385479916,4,0,0,4,2.007
1991716644473195_2481671485477706,20,5,0,25,9.3174
1991716644473195_2481727715472083,1,0,0,1,0.4215
1991716644473195_2481779055466949,2,0,0,2,0.8808
1991716644473195_2481781922133329,1,1,0,2,0.4754
1991716644473195_2481782642133257,18,7,0,25,10.2011
1991716644473195_2481916578786530,1,0,0,1,0.4404
1991716644473195_2482305225414332,7,0,0,7,3.7402
1991716644473195_2482323515412503,2,10,2,14,-0.4505
1991716644473195_2482332688744919,1,0,0,1,0.4404
1991716644473195_2482378478740340,3,0,0,3,1.6795
1991716644473195_2482390322072489,2,0,0,2,0.9331
1991716644473195_2482417952069726,2,0,0,2,1.2699
1991716644473195_2482443598733828,0,1,0,1,0
1991716644473195_2482459455398909,17,7,1,25,8.468
1991716644473195_2482494542062067,5,10,1,16,1.7295
1991716644473195_2482494835395371,2,0,0,2,1.1109
1991716644473195_2482554848722703,3,0,0,3,1.5897
1991716644473195_2482559528722235,1,0,0,1,0.4754
1991716644473195_2482576755387179,1,2,0,3,0.4404
1991716644473195_2482586372052884,3,2,0,5,1.4338
1991716644473195_2482606352050886,8,0,0,8,3.6917
1991716644473195_2482622392049282,1,0,0,1,0.4215
1991716644473195_2482633532048168,1,0,0,1,0.5994
1991716644473195_2482667322044789,1,0,0,1,0.4404
1991716644473195_2482682862043235,1,0,0,1,0.4215
1991716644473195_2482709832040538,24,1,0,25,10.9554
1991716644473195_2483094275335427,2,1,0,3,0.8808
1991716644473195_2483183765326478,14,2,0,16,6.4778
1991716644473195_2483225391988982,1,0,0,1,0.4215
1991716644473195_2483341751977346,0,1,0,1,0
1991716644473195_2483347351976786,1,0,0,1,0.4404
1991716644473195_2483376721973849,4,0,0,4,1.779
1991716644473195_2483446061966915,4,0,0,4,2.2587
1991716644473195_2483553501956171,1,0,0,1,0.4404
1991716644473195_2483613585283496,11,1,0,12,6.1929
1991716644473195_2483625051949016,1,0,0,1,0.7408
1991716644473195_2484129148565273,2,0,0,2,0.8808
1991716644473195_2484139755230879,19,3,3,25,8.2429
1991716644473195_2484151778563010,10,1,0,11,5.1557
1991716644473195_2484182265226628,0,1,0,1,0
1991716644473195_2484227281888793,5,0,0,5,3.2144
1991716644473195_2484264968551691,15,4,0,19,7.3403
1991716644473195_2484422978535890,1,0,0,1,0.2023
1991716644473195_2484481925196662,1,0,0,1,0.4927
1991716644473195_2484840441827477,5,0,0,5,2.4005
1991716644473195_2484844258493762,1,0,0,1,0.2732
1991716644473195_2484968935147961,1,0,0,1,0.6908
1991716644473195_2485823298395858,3,0,0,3,1.3023
1991716644473195_2485826888395499,14,6,5,25,5.4998
1991716644473195_2485873471724174,3,0,0,3,1.3023
1991716644473195_2485884931723028,1,0,0,1,0.4404
1991716644473195_2485944791717042,1,0,0,1,0.4404
1991716644473195_2485990918379096,1,1,0,2,0.4404
1991716644473195_2486039321707589,4,1,0,5,2.0928
1991716644473195_2486157275029127,1,13,0,14,0.4754
1991716644473195_2486560588322129,3,0,0,3,1.6795
1991716644473195_2486631808315007,1,0,0,1,0.4404
1991716644473195_2486727091638812,5,18,2,25,1.5672
1991716644473195_2486746271636894,21,3,1,25,9.8666
1991716644473195_2486780068300181,1,0,0,1,0.7269
1991716644473195_2486781934966661,1,0,0,1,0.4404
1991716644473195_2486790244965830,1,0,0,1,0.4754
1991716644473195_2486793154965539,2,1,0,3,0.9331
1991716644473195_2486828551628666,18,7,0,25,8.1326
1991716644473195_2486842441627277,2,0,0,2,1.0464
1991716644473195_2486846078293580,3,0,0,3,1.3593
1991716644473195_2486864021625119,4,2,0,6,2.0193
1991716644473195_2486919241619597,1,0,0,1,0.7269
1991716644473195_2486936034951251,4,0,0,4,2.4696
1991716644473195_2486977004947154,3,0,1,4,0.8808
1991716644473195_2486996601611861,1,0,0,1,0.4215
1991716644473195_2487034964941358,0,1,0,1,0
1991716644473195_2487075131604008,6,0,0,6,3.5997
1991716644473195_2487426338235554,2,1,0,3,0.8808
1991716644473195_2487453234899531,23,2,0,25,13.7208
1991716644473195_2487457111565810,1,0,0,1,0.4215
1991716644473195_2487493111562210,21,4,0,25,12.1364
1991716644473195_2487528048225383,6,0,0,6,3.1409
1991716644473195_2487528794891975,2,1,0,3,1.8983
1991716644473195_2487551188223069,1,0,0,1,0.2732
1991716644473195_2487553008222887,1,0,0,1,0.4404
1991716644473195_2487610684883786,1,0,0,1,0.4404
1991716644473195_2487627484882106,2,0,0,2,0.9789
1991716644473195_2487627801548741,1,0,0,1,0.5859
1991716644473195_2487674201544101,4,0,0,4,1.9622
1991716644473195_2487681848210003,1,0,0,1,0.0772
1991716644473195_2487684954876359,1,0,0,1,0.4215
1991716644473195_2487689094875945,6,1,0,7,2.8806
1991716644473195_2487690634875791,1,0,0,1,0.4404
1991716644473195_2487698491541672,1,0,0,1,0.8176
1991716644473195_2487723244872530,1,1,0,2,0.34
1991716644473195_2487735371537984,9,4,0,13,4.9465
1991716644473195_2487754158202772,7,3,0,10,3.7987
1991716644473195_2487760061535515,2,0,0,2,0.8619
1991716644473195_2487771478201040,1,1,0,2,0.4215
1991716644473195_2487905461520975,1,0,0,1,0.5994
1991716644473195_2488272844817570,1,0,0,1,0.4215
1991716644473195_2488281758150012,0,1,0,1,0
1991716644473195_2488309321480589,1,1,0,2,0.5994
1991716644473195_2488356058142582,1,0,0,1,0.6249
1991716644473195_2488360661475455,5,5,0,10,1.9476
1991716644473195_2488365704808284,0,2,0,2,0
1991716644473195_2488382364806618,2,0,0,2,0.8619
1991716644473195_2488397941471727,3,0,0,3,1.612
1991716644473195_2488399754804879,0,1,0,1,0
1991716644473195_2488410141470507,1,1,0,2,0.4215
1991716644473195_2488477641463757,5,2,0,7,2.3636
1991716644473195_2488491808129007,2,0,0,2,1.0209
1991716644473195_2488529348125253,4,0,0,4,1.8669
1991716644473195_2488544761457045,4,0,0,4,1.9622
1991716644473195_2488556138122574,9,1,0,10,5.0072
1991716644473195_2488575524787302,6,1,0,7,2.8374
1991716644473195_2488641251447396,2,1,0,3,0.8808
1991716644473195_2488643598113828,5,0,0,5,2.5966
1991716644473195_2488662668111921,0,1,0,1,0
1991716644473195_2488663424778512,1,0,0,1,0.4199
1991716644473195_2488704038107784,5,0,0,5,3.2041
1991716644473195_2488772261434295,1,0,0,1,0.4404
1991716644473195_2488778518100336,18,5,1,24,8.5442
1991716644473195_2488780478100140,1,0,0,1,0.4215
1991716644473195_2489092594735595,1,1,0,2,0.4767
1991716644473195_2489093731402148,4,0,0,4,2.2388
1991716644473195_2489151391396382,1,1,0,2,0.6908
1991716644473195_2489186624726192,2,3,0,5,0.843
1991716644473195_2489187681392753,0,1,0,1,0
1991716644473195_2489198154725039,2,2,0,4,0.843
1991716644473195_2489317278046460,8,2,0,10,3.5743
1991716644473195_2489372968040891,7,1,0,8,4.0744
1991716644473195_2489377151373806,4,0,0,4,1.7616
1991716644473195_2489378014707053,2,0,0,2,1.3263
1991716644473195_2489397831371738,1,0,0,1,0.6249
1991716644473195_2489402241371297,2,1,0,3,1.0398
1991716644473195_2489403471371174,4,2,0,6,2.9587
1991716644473195_2489428251368696,5,1,0,6,2.8163
1991716644473195_2489433154701539,1,0,0,1,0.4215
1991716644473195_2489448801366641,1,1,0,2,0.4404
1991716644473195_2489505954694259,3,0,0,3,1.6205
1991716644473195_2489514301360091,6,3,0,9,3.4537
1991716644473195_2489515698026618,2,0,0,2,0.9158
1991716644473195_2489527478025440,1,0,0,1,0.4404
1991716644473195_2489530601358461,1,0,0,1,0.4404
1991716644473195_2489540738024114,1,0,1,2,-0.4519
1991716644473195_2489540888024099,1,0,0,1,0.4754
1991716644473195_2489553021356219,3,2,0,5,1.3212
1991716644473195_2489562254688629,2,0,0,2,0.8619
1991716644473195_2489569741354547,1,0,0,1,0.6249
1991716644473195_2489616021349919,8,17,0,25,1.4042
1991716644473195_2489643511347170,1,0,0,1,0.6249
1991716644473195_2489662588011929,1,1,0,2,0.6249
1991716644473195_2489717981339723,17,8,0,25,8.4319
1991716644473195_2489728824671972,0,0,1,1,-0.0191
1991716644473195_2489779608000227,8,12,3,23,2.2157
1991716644473195_2490015954643259,1,0,0,1,0.4927
1991716644473195_2490035034641351,12,0,0,12,5.9571
1991716644473195_2490089304635924,1,0,0,1,0.4404
1991716644473195_2490100411301480,8,0,0,8,4.6781
1991716644473195_2490125694632285,7,2,0,9,3.1887
1991716644473195_2490132011298320,19,3,0,22,8.6506
1991716644473195_2490156714629183,1,0,0,1,0.6249
1991716644473195_2490165314628323,9,0,0,9,6.1221
1991716644473195_2490171104627744,1,3,0,4,0.4404
1991716644473195_2490219117956276,11,13,1,25,3.5589
1991716644473195_2490222977955890,1,1,0,2,0.4215
1991716644473195_2490231421288379,3,1,0,4,1.242
1991716644473195_2490249127953275,4,1,0,5,1.8501
1991716644473195_2490252394619615,0,1,0,1,0
1991716644473195_2490255921285929,4,0,0,4,2.0982
1991716644473195_2490261777952010,3,2,0,5,1.5057
1991716644473195_2490267087951479,2,0,0,2,0.843
1991716644473195_2490271394617715,1,0,0,1,0.4404
1991716644473195_2490275217950666,1,0,0,1,0.6249
1991716644473195_2490277941283727,2,0,0,2,1.1175
1991716644473195_2490282391283282,4,1,0,5,2.0928
1991716644473195_2490319561279565,1,0,0,1,0.4404
1991716644473195_2490337911277730,2,0,0,2,1.3157
1991716644473195_2490385721272949,10,0,0,10,4.91
1991716644473195_2490398841271637,2,2,0,4,1.0464
1991716644473195_2490431294601725,1,1,0,2,0.4404
1991716644473195_2490467331264788,8,0,0,8,3.7611
1991716644473195_2490480051263516,0,1,0,1,0
1991716644473195_2490554581256063,4,0,0,4,2.1829
1991716644473195_2490637134581141,3,5,0,8,1.277
1991716644473195_2490696637908524,3,0,0,3,1.5202
1991716644473195_2490957684549086,1,0,0,1,0.4215
1991716644473195_2490961044548750,5,0,0,5,3.0361
1991716644473195_2490982844546570,0,0,1,1,-0.296
1991716644473195_2491003961211125,5,0,0,5,2.4728
1991716644473195_2491090037869184,3,5,0,8,1.3161
1991716644473195_2491124231199098,5,0,0,5,2.5261
1991716644473195_2491251364519718,1,0,0,1,0.5994
1991716644473195_2491395461171975,3,0,0,3,1.7252
1991716644473195_2491396731171848,2,0,0,2,1.0464
1991716644473195_2491401684504686,1,0,0,1,0.6249
1991716644473195_2491419267836261,1,0,0,1,0.9055
1991716644473195_2491708134474041,3,0,0,3,1.558
1991716644473195_2491710874473767,7,1,0,8,4.2958
1991716644473195_2491729967805191,2,0,0,2,1.1003
1991716644473195_2491737774471077,3,0,0,3,2.146
1991716644473195_2491853187792869,2,0,0,2,1.2498
1991716644473195_2491905767787611,8,3,0,11,3.9937
1991716644473195_2491917587786429,1,0,0,1,0.6249
1991716644473195_2491942174450637,19,2,0,21,10.0561
1991716644473195_2491961007782087,1,1,0,2,0.4927
1991716644473195_2492094804435374,3,0,0,3,1.3373
1991716644473195_2492100211101500,6,0,0,6,2.7608
1991716644473195_2492100827768105,1,0,0,1,0.4215
1991716644473195_2492101321101389,1,0,0,1,0.6249
1991716644473195_2492148321096689,3,1,1,5,1.0751
1991716644473195_2492186807759507,2,0,0,2,1.0464
1991716644473195_2492191204425734,9,0,0,9,4.7579
1991716644473195_2492224227755765,25,0,0,25,12.5618
1991716644473195_2492245621086959,1,0,0,1,0.4404
1991716644473195_2492270614417793,1,0,0,1,0.4754
1991716644473195_2492314687746719,2,0,0,2,0.5176
1991716644473195_2492325197745668,7,3,0,10,4.4935
1991716644473195_2492706651040856,1,3,0,4,0.4215
1991716644473195_2492715344373320,2,0,0,2,1.6968
1991716644473195_2492721117706076,5,0,0,5,2.3865
1991716644473195_2492779124366942,4,2,0,6,2.5162
1991716644473195_2492798371031684,3,1,0,4,1.7816
1991716644473195_2492801431031378,2,0,0,2,1.0398
1991716644473195_2492880081023513,1,0,0,1,0.4404
1991716644473195_2492890374355817,2,0,0,2,0.9343
1991716644473195_2492921074352747,3,0,0,3,1.7295
1991716644473195_2492929354351919,1,0,0,1,0.4019
1991716644473195_2492992191012302,1,0,0,1,0.4404
1991716644473195_2493018597676328,12,1,0,13,5.7187
1991716644473195_2493052227672965,6,0,0,6,2.6774
1991716644473195_2493062144338640,3,1,0,4,1.4802
1991716644473195_2493062367671951,6,0,1,7,3.1052
1991716644473195_2493126250998896,6,0,0,6,3.0512
1991716644473195_2493152200996301,0,1,0,1,0
1991716644473195_2493159554328899,3,0,0,3,1.277
1991716644473195_2493163217661866,1,0,0,1,0.6249
1991716644473195_2493180514326803,22,3,0,25,11.6619
1991716644473195_2493206447657543,3,0,0,3,1.3212
1991716644473195_2493207264324128,3,0,0,3,1.3212
1991716644473195_2493232224321632,3,1,0,4,1.9139
1991716644473195_2493321264312728,1,1,0,2,0.4215
1991716644473195_2493507330960788,16,2,0,18,8.2071
1991716644473195_2493511547627033,20,3,0,23,9.5763
1991716644473195_2493527887625399,5,1,0,6,2.6184
1991716644473195_2493539530957568,1,0,0,1,0.5994
1991716644473195_2493613574283497,2,0,0,2,1.0398
1991716644473195_2493671167611071,4,1,0,5,1.9811
1991716644473195_2493689154275939,8,1,2,11,2.8569
1991716644473195_2493724844272370,4,6,1,11,1.8326
1991716644473195_2493731077605080,6,0,1,7,3.1743
1991716644473195_2493742507603937,10,0,0,10,5.2883
1991716644473195_2493746847603503,8,2,0,10,3.8639
1991716644473195_2493778504267004,3,0,0,3,1.5057
1991716644473195_2493828197595368,3,1,0,4,1.519
1991716644473195_2493852990926222,6,2,0,8,3.1962
1991716644473195_2493864824258372,2,0,0,2,1.2675
1991716644473195_2493876627590525,7,17,1,25,2.0051
1991716644473195_2493880367590151,7,1,0,8,3.5827
1991716644473195_2493894404255414,23,1,0,24,11.9908
1991716644473195_2493935007584687,1,0,0,1,0.6597
1991716644473195_2493938167584371,2,1,0,3,0.8808
1991716644473195_2493940390917482,11,2,0,13,5.1231
1991716644473195_2494090617569126,8,4,0,12,4.2423
1991716644473195_2494346060876915,2,0,0,2,0.8808
1991716644473195_2494358824208972,1,0,0,1,0.4404
1991716644473195_2494380034206851,4,0,0,4,1.8139
1991716644473195_2494382330873288,1,0,0,1,0.5994
1991716644473195_2494411617537026,0,1,0,1,0
1991716644473195_2494502834194571,2,0,0,2,0.843
1991716644473195_2494529037525284,2,0,0,2,0.8808
1991716644473195_2494581040853417,1,0,0,1,0.4404
1991716644473195_2494581380853383,1,0,0,1,0.4404
1991716644473195_2494581604186694,2,8,0,10,0.68
1991716644473195_2494607774184077,1,0,0,1,0.4215
1991716644473195_2494634920848029,2,23,0,25,0.6766
1991716644473195_2494661307512057,1,0,0,1,0.6249
1991716644473195_2494679640843557,1,0,0,1,0.4215
1991716644473195_2494739460837575,1,1,0,2,0.4404
1991716644473195_2494746087503579,1,0,0,1,0.4215
1991716644473195_2494787544166100,1,0,0,1,0.2732
1991716644473195_2494823200829201,2,0,0,2,1.1312
1991716644473195_2494826070828914,2,0,0,2,0.9331
1991716644473195_2494854850826036,2,0,0,2,0.8619
1991716644473195_2495293024115552,0,1,0,1,0
1991716644473195_2495305077447680,2,0,0,2,0.9853
1991716644473195_2495379580773563,3,0,0,3,1.7674
1991716644473195_2495520647426123,1,0,0,1,0.4215
1991716644473195_2496169054027949,1,0,0,1,0.4404
1991716644473195_2496303767347811,13,2,0,15,7.8963
1991716644473195_2496326027345585,1,0,0,1,0.4404
1991716644473195_2496333917344796,4,0,0,4,1.7049
1991716644473195_2496340567344131,1,0,0,1,0.6249
1991716644473195_2496425970668924,21,4,0,25,12.972
1991716644473195_2496429160668605,3,1,0,4,1.4478
1991716644473195_2496446824000172,0,1,0,1,0
1991716644473195_2496556570655864,1,0,0,1,0.4404
1991716644473195_2496611103983744,0,1,0,1,0
1991716644473195_2496632663981588,11,1,0,12,5.6805
1991716644473195_2496635567314631,16,9,0,25,9.3377
1991716644473195_2497322390579282,2,2,0,4,1.2943
1991716644473195_2497369217241266,8,0,0,8,4.3586
1991716644473195_2497400777238110,4,0,0,4,1.9272
1991716644473195_2497600343884820,1,0,0,1,0.4215
1991716644473195_2497844083860446,1,0,0,1,0.4404
1991716644473195_2497920277186160,11,1,0,12,5.0301
1991716644473195_2497922413852613,4,0,0,4,2.233
1991716644473195_2498004520511069,4,0,0,4,2.0428
1991716644473195_2498022053842649,4,0,0,4,2.1051
1991716644473195_2498086360502885,2,0,0,2,1.3562
1991716644473195_2498102087167979,0,1,0,1,0
1991716644473195_2498108287167359,4,0,0,4,2.0334
1991716644473195_2498127153832139,2,3,0,5,0.8808
1991716644473195_2498149603829894,7,1,0,8,3.6551
1991716644473195_2498270337151154,7,0,0,7,3.7739
1991716644473195_2498318843812970,1,0,0,1,0.4404
1991716644473195_2498525977125590,1,0,0,1,0.6588
1991716644473195_2498526587125529,1,0,0,1,0.4754
1991716644473195_2498620313782823,2,1,0,3,0.9331
1991716644473195_2498757397102448,5,0,0,5,3.0313
1991716644473195_2498758820435639,16,4,0,20,9.012
1991716644473195_2498853527092835,1,0,0,1,0.4404
1991716644473195_2498856437092544,4,0,0,4,1.7231
1991716644473195_2498858593758995,10,0,0,10,4.7654
1991716644473195_2498858700425651,1,0,0,1,0.4404
1991716644473195_2498898453755009,13,0,0,13,6.9376
1991716644473195_2498914777086710,3,0,0,3,1.5057
1991716644473195_2498930243751830,1,0,0,1,0.4215
1991716644473195_2498956047082583,8,1,0,9,3.9783
1991716644473195_2498989187079269,1,1,0,2,0.7003
1991716644473195_2499052590406262,1,0,0,1,0.4404
1991716644473195_2499110027067185,1,0,0,1,0.6908
1991716644473195_2499129970398524,5,1,0,6,2.3421
1991716644473195_2499140213730833,4,0,0,4,1.7616
1991716644473195_2499544213690433,2,3,0,5,0.8808
1991716644473195_2499568017021386,2,1,0,3,0.8808
1991716644473195_2499717610339760,1,0,0,1,0.4404
1991716644473195_2499718490339672,1,11,0,12,0.6249
1991716644473195_2499803050331216,2,1,0,3,1.2245
1991716644473195_2499842530327268,18,2,1,21,8.7336
1991716644473195_2499848300326691,12,0,0,12,5.6718
1991716644473195_2499857586992429,1,0,0,1,0.4404
1991716644473195_2499862126991975,1,0,0,1,0.4404
1991716644473195_2499885516989636,1,0,0,1,0.6249
1991716644473195_2499889640322557,2,1,0,3,0.8808
1991716644473195_2499908556987332,1,0,0,1,0.7351
1991716644473195_2499913613653493,1,0,0,1,0.3612
1991716644473195_2499952386982949,1,0,0,1,0.4404
1991716644473195_2499965713648283,2,0,0,2,0.8969
1991716644473195_2499966980314823,3,0,0,3,1.5407
1991716644473195_2499982943646560,4,1,0,5,2.8999
1991716644473195_2499987943646060,3,0,0,3,1.7865
1991716644473195_2500037743641080,4,0,0,4,1.9811
1991716644473195_2500092203635634,3,0,0,3,1.3918
1991716644473195_2500401803604674,7,0,0,7,3.6527
1991716644473195_2500436436934544,8,2,0,10,3.5532
1991716644473195_2500459700265551,2,0,0,2,1.2734
1991716644473195_2500484226929765,10,0,0,10,4.6725
1991716644473195_2500547486923439,3,0,0,3,1.8747
1991716644473195_2500552880256233,3,0,0,3,1.4868
1991716644473195_2500563080255213,1,0,0,1,0.6597
1991716644473195_2500569226921265,2,0,0,2,1.2696
1991716644473195_2500570856921102,1,0,0,1,0.5859
1991716644473195_2500610653583789,2,0,0,2,1.2243
1991716644473195_2500640190247502,3,2,0,5,1.1701
1991716644473195_2500743166903871,6,3,0,9,2.9301
1991716644473195_2500825273562327,7,0,0,7,4.3885
1991716644473195_2500900576888130,1,0,0,1,0.5994
1991716644473195_2500909780220543,1,0,0,1,0.7297
1991716644473195_2500970556881132,1,0,0,1,0.4404
1991716644473195_2501282790183242,9,1,0,10,6.7412
1991716644473195_2501316410179880,1,0,0,1,0.5859
1991716644473195_2501326103512244,1,0,0,1,0.4754
1991716644473195_2501329996845188,10,5,0,15,5.4874
1991716644473195_2501339980177523,7,1,0,8,3.4155
1991716644473195_2501340616844126,0,1,0,1,0
1991716644473195_2501343583510496,6,1,0,7,3.1642
1991716644473195_2501344053510449,11,0,0,11,4.9583
1991716644473195_2501353543509500,2,0,0,2,0.9331
1991716644473195_2501360120175509,2,3,0,5,1.0773
1991716644473195_2501373706840817,1,0,0,1,0.7501
1991716644473195_2501392383505616,2,0,0,2,1.5445
1991716644473195_2501441496834038,2,0,0,2,0.8808
1991716644473195_2501460196832168,1,0,0,1,0.4404
1991716644473195_2501467190164802,2,0,0,2,0.8808
1991716644473195_2501546830156838,1,0,0,1,0.4404
1991716644473195_2501557070155814,1,0,0,1,0.4404
1991716644473195_2501575373487317,1,1,0,2,0.4215
1991716644473195_2501585683486286,9,1,0,10,5.0825
1991716644473195_2501590653485789,20,1,0,21,10.7739
1991716644473195_2501603993484455,4,0,0,4,2.6239
1991716644473195_2501617900149731,1,0,0,1,0.5994
1991716644473195_2501658586812329,1,0,0,1,0.6588
1991716644473195_2501702153474639,1,0,0,1,0.5994
1991716644473195_2501702926807895,3,0,0,3,1.4988
1991716644473195_2501715920139929,3,0,0,3,1.8855
1991716644473195_2501735740137947,19,6,0,25,9.4091
1991716644473195_2502032480108273,1,0,0,1,0.4767
1991716644473195_2502109920100529,23,2,0,25,12.1977
1991716644473195_2502120006766187,3,0,0,3,1.7202
1991716644473195_2502161826762005,1,0,0,1,0.6249
1991716644473195_2502161870095334,3,0,0,3,1.8583
1991716644473195_2502164703428384,7,1,0,8,3.8449
1991716644473195_2502167670094754,4,6,0,10,1.8524
1991716644473195_2502171030094418,5,0,0,5,3.1384
1991716644473195_2502173816760806,5,0,0,5,2.706
1991716644473195_2502174976760690,14,3,0,17,7.6138
1991716644473195_2502178313427023,7,2,0,9,4.426
1991716644473195_2502182113426643,3,0,0,3,1.2063
1991716644473195_2502189786759209,4,0,0,4,2.6478
1991716644473195_2502205033424351,9,0,0,9,5.2184
1991716644473195_2502213816756806,12,0,0,12,6.4529
1991716644473195_2502231963421658,1,1,0,2,0.4215
1991716644473195_2502244216753766,2,1,0,3,1.0209
1991716644473195_2502267970084724,2,0,0,2,0.9331
1991716644473195_2502275690083952,1,0,0,1,0.4019
1991716644473195_2502275923417262,1,0,0,1,0.5106
1991716644473195_2502283956749792,1,0,0,1,0.9337
1991716644473195_2502310673413787,2,0,0,2,1.1713
1991716644473195_2502333893411465,2,1,0,3,1.1176
1991716644473195_2502379786740209,3,0,0,3,1.6578
1991716644473195_2502393216738866,6,0,0,6,2.6203
1991716644473195_2502553333389521,2,1,0,3,1.0209
1991716644473195_2502574330054088,3,0,0,3,1.6997
1991716644473195_2502877513357103,1,0,0,1,0.4404
1991716644473195_2502907093354145,3,0,0,3,1.4068
1991716644473195_2502983410013180,4,2,0,6,1.6635
1991716644473195_2503070100004511,2,0,0,2,0.9508
1991716644473195_2503126406665547,1,0,0,1,0.6908
1991716644473195_2503152203329634,19,5,1,25,10.184
1991716644473195_2503161209995400,2,9,1,12,0.8913
1991716644473195_2503210839990437,4,8,0,12,1.7509
1991716644473195_2503214773323377,1,2,0,3,0.5859
1991716644473195_2503272896650898,2,3,0,5,0.8288
1991716644473195_2503333896644798,1,0,0,1,0.4215
1991716644473195_2503356353309219,1,0,0,1,0.4215
1991716644473195_2503388549972666,0,1,0,1,0
1991716644473195_2503409049970616,1,0,0,1,0.4215
1991716644473195_2503439613300893,1,0,0,1,0.4404
1991716644473195_2503441596634028,4,0,0,4,2.5622
1991716644473195_2503450099966511,3,5,0,8,0.7136
1991716644473195_2503706809940840,2,0,0,2,0.9158
1991716644473195_2503720666606121,6,19,0,25,1.6955
1991716644473195_2503856943259160,23,2,0,25,12.2458
1991716644473195_2503925979918923,3,0,0,3,1.7045
1991716644473195_2503944406583747,2,0,0,2,1.0398
1991716644473195_2503947219916799,23,2,0,25,12.7377
1991716644473195_2503990423245812,2,1,0,3,0.9508
1991716644473195_2504019956576192,2,1,0,3,0.8555
1991716644473195_2504049399906581,1,0,0,1,0.4404
1991716644473195_2504069796571208,1,0,0,1,0.4404
1991716644473195_2504136296564558,2,4,0,6,1.2463
1991716644473195_2504147213230133,1,0,0,1,0.4404
1991716644473195_2504212146556973,1,0,0,1,0.4404
1991716644473195_2504238869887634,1,0,0,1,0.4927
1991716644473195_2504240886554099,11,1,0,12,5.5093
1991716644473195_2504280689883452,1,0,0,1,0.4215
1991716644473195_2504480499863471,5,15,0,20,2.0069
1991716644473195_2504490869862434,6,12,0,18,1.9706
1991716644473195_2504515973193257,2,2,0,4,0.8619
1991716644473195_2504531423191712,3,4,0,7,1.3357
1991716644473195_2504603066517881,2,1,0,3,1.0473
1991716644473195_2504613793183475,2,0,0,2,1.1623
1991716644473195_2504615573183297,4,0,0,4,2.0987
1991716644473195_2504619889849532,1,0,0,1,0.9033
1991716644473195_2504625359848985,2,0,0,2,1.1968
1991716644473195_2504650709846450,1,0,0,1,0.0772
1991716644473195_2504759079835613,3,0,0,3,2.0049
1991716644473195_2504844683160386,1,1,0,2,0.4404
1991716644473195_2504849979826523,2,0,0,2,0.9158
1991716644473195_2504874299824091,20,5,0,25,11.3477
1991716644473195_2504878039823717,15,2,0,17,7.3121
1991716644473195_2504878569823664,2,0,0,2,0.843
1991716644473195_2504891913155663,7,1,0,8,3.7657
1991716644473195_2504936996484488,1,0,0,1,0.4215
1991716644473195_2505069216471266,3,1,0,4,2.048
1991716644473195_2505399136438274,1,0,0,1,0.4215
1991716644473195_2505409093103945,5,1,0,6,2.2004
1991716644473195_2505479053096949,3,1,0,4,1.3357
1991716644473195_2505528929758628,5,2,0,7,2.644
1991716644473195_2505555826422605,2,2,1,5,0.6066
1991716644473195_2505573189754202,1,0,0,1,0.5994
1991716644473195_2505585519752969,3,3,0,6,1.6537
1991716644473195_2505586866419501,1,0,0,1,0.6369
1991716644473195_2505650029746518,1,1,0,2,0.4404
1991716644473195_2505652549746266,3,0,1,4,1.3146
1991716644473195_2505659003078954,4,0,0,4,1.7966
1991716644473195_2505661073078747,1,0,0,1,0.4404
1991716644473195_2505682013076653,1,3,0,4,0.296
1991716644473195_2505692283075626,1,1,0,2,0.4215
1991716644473195_2505751123069742,1,1,0,2,0.6249
1991716644473195_2505792096398978,1,0,0,1,0.4404
1991716644473195_2505820663062788,23,2,0,25,13.279
1991716644473195_2505821626396025,6,2,0,8,3.1989
1991716644473195_2506210726357115,2,1,0,3,1.0653
1991716644473195_2506226179688903,2,0,0,2,1.0748
1991716644473195_2506240593020795,8,17,0,25,2.8104
1991716644473195_2506242883020566,22,3,0,25,11.9867
1991716644473195_2506245256353662,2,0,0,2,1.0209
1991716644473195_2506249656353222,17,3,0,20,8.6929
1991716644473195_2506341823010672,10,0,0,10,5.9419
1991716644473195_2506381296340058,0,3,0,3,0
1991716644473195_2506396956338492,20,0,0,20,11.4299
1991716644473195_2506420119669509,1,1,0,2,0.6249
1991716644473195_2506425329668988,2,0,0,2,1.0464
1991716644473195_2506477386330449,3,2,0,5,1.4828
1991716644473195_2506517469659774,3,0,0,3,1.5708
1991716644473195_2506595572985297,3,0,0,3,1.6713
1991716644473195_2506739119637609,12,8,0,20,5.8068
1991716644473195_2507029309608590,2,0,0,2,0.8773
1991716644473195_2507072839604237,1,0,0,1,0.4404
1991716644473195_2507090666269121,5,0,0,5,1.7802
1991716644473195_2507169969594524,1,0,0,1,0.4404
1991716644473195_2507180346260153,5,2,1,8,2.0279
1991716644473195_2507265289584992,7,1,0,8,3.3849
1991716644473195_2507267039584817,1,2,0,3,0.4404
1991716644473195_2507288109582710,7,0,0,7,3.944
1991716644473195_2507310072913847,5,1,0,6,2.7062
1991716644473195_2507376382907216,1,0,0,1,0.6249
1991716644473195_2507476979563823,3,0,0,3,1.6612
1991716644473195_2507504096227778,1,0,0,1,0.4404
1991716644473195_2507828819528639,2,0,0,2,0.7631
1991716644473195_2507900476188140,4,3,1,8,1.6533
1991716644473195_2507907986187389,1,0,0,1,0.4215
1991716644473195_2507926362852218,6,0,0,6,3.3551
1991716644473195_2507941099517411,3,1,0,4,1.8401
1991716644473195_2507943836183804,3,0,0,3,1.9767
1991716644473195_2507988906179297,2,0,0,2,1.3518
1991716644473195_2507997482845106,24,1,0,25,14.0332
1991716644473195_2508027526175435,3,0,0,3,1.3023
1991716644473195_2508089612835893,2,0,0,2,1.2498
1991716644473195_2508096106168577,1,0,0,1,0.5994
1991716644473195_2508096406168547,4,2,0,6,1.7588
1991716644473195_2508102716167916,1,0,0,1,0.5719
1991716644473195_2508134662831388,1,0,0,1,0.5719
1991716644473195_2508139256164262,21,4,0,25,10.1803
1991716644473195_2508153562829498,4,4,0,8,2.531
1991716644473195_2508163399495181,2,0,0,2,1.4453
1991716644473195_2508166862828168,4,1,0,5,2.4688
1991716644473195_2508193132825541,1,0,0,1,0.5719
1991716644473195_2508212002823654,1,0,0,1,0.5719
1991716644473195_2508232546154933,0,1,0,1,0
1991716644473195_2508242139487307,0,1,0,1,0
1991716644473195_2508315636146624,4,1,0,5,1.7777
1991716644473195_2508328262812028,2,0,0,2,1.1003
1991716644473195_2508365966141591,1,1,1,3,0.1255
1991716644473195_2508627062782148,1,0,0,1,0.4754
1991716644473195_2508652739446247,2,0,0,2,0.9331
1991716644473195_2508659976112190,1,0,0,1,0.6908
1991716644473195_2508668526111335,1,0,0,1,0.5719
1991716644473195_2508669492777905,1,1,0,2,0.4404
1991716644473195_2508689489442572,10,1,0,11,4.0355
1991716644473195_2508690839442437,8,0,0,8,4.4059
1991716644473195_2508696912775163,5,1,0,6,2.1039
1991716644473195_2508794089432112,5,1,0,6,3.384
1991716644473195_2508797692765085,0,1,0,1,0
1991716644473195_2508841302760724,1,0,0,1,0.4215
1991716644473195_2508859632758891,3,0,0,3,1.2834
1991716644473195_2508874326090755,6,1,0,7,3.3534
1991716644473195_2508986606079527,3,2,0,5,1.6815
1991716644473195_2509052566072931,11,0,0,11,5.6142
1991716644473195_2509124446065743,5,0,0,5,2.794
1991716644473195_2509142272730627,1,0,0,1,0.5994
1991716644473195_2509143876063800,4,0,0,4,1.7966
1991716644473195_2509281779383343,1,0,0,1,0.4199
1991716644473195_2509464896031698,0,1,0,1,0
1991716644473195_2509560636022124,1,0,0,1,0.6901
1991716644473195_2509564129355108,2,0,0,2,0.8808
1991716644473195_2509596436018544,2,2,0,4,0.7136
1991716644473195_2509645776013610,1,0,0,1,0.4404
1991716644473195_2509663649345156,1,0,0,1,0.4404
1991716644473195_2509794849332036,2,0,0,2,1.0773
1991716644473195_2509826685995519,2,3,0,5,0.8981
1991716644473195_2510559092588945,8,0,0,8,4.3555
1991716644473195_2510605902584264,7,1,0,8,3.5054
1991716644473195_2510900909221430,1,0,0,1,0.4927
1991716644473195_2510931529218368,1,0,0,1,0.4404
1991716644473195_2511310982513756,5,0,0,5,2.5674
1991716644473195_2511329332511921,4,0,0,4,1.9367
1991716644473195_2511408675837320,3,0,0,3,1.7157
1991716644473195_2511497309161790,2,0,0,2,1.1988
1991716644473195_2511519965826191,1,0,0,1,0.4404
1991716644473195_2511575555820632,13,2,0,15,6.7795
1991716644473195_2511589675819220,0,1,0,1,0
1991716644473195_2511702889141232,12,1,0,13,7.3822
1991716644473195_2511708542474000,1,1,0,2,0.4754
1991716644473195_2511738482471006,1,0,0,1,0.4404
1991716644473195_2512012292443625,10,3,0,13,6.1994
1991716644473195_2512106532434201,1,0,0,1,0.4404
1991716644473195_2512176929093828,5,0,0,5,2.4834
1991716644473195_2512190869092434,2,0,0,2,1.1003
1991716644473195_2512196369091884,5,0,0,5,3.0618
1991716644473195_2512206209090900,1,0,0,1,0.4404
1991716644473195_2512213519090169,19,6,0,25,10.736
1991716644473195_2512285245749663,14,1,1,16,6.1813
1991716644473195_2512292615748926,1,1,0,2,0.4404
1991716644473195_2512297559081765,0,1,0,1,0
1991716644473195_2512336129077908,1,1,0,2,0.4404
1991716644473195_2512380822406772,3,0,0,3,1.6077
1991716644473195_2512476902397164,3,0,0,3,1.5152
1991716644473195_2512484969063024,25,1,0,26,16.3098
1991716644473195_2512566029054918,3,0,0,3,1.507
1991716644473195_2512855522359302,1,2,0,3,0.5994
1991716644473195_2512889572355897,2,0,0,2,0.9142
1991716644473195_2512906059020915,9,0,0,9,4.2124
1991716644473195_2512927335685454,1,1,0,2,0.659
1991716644473195_2512934229018098,3,0,0,3,1.3196
1991716644473195_2513041812340673,6,2,0,8,4.4888
1991716644473195_2513123262332528,1,1,0,2,0.4215
1991716644473195_2513203742324480,1,0,0,1,0.4404
1991716644473195_2513248375653350,2,1,0,3,1.2488
1991716644473195_2513318468979674,18,6,1,25,9.1941
1991716644473195_2513391612305693,3,0,0,3,1.5527
1991716644473195_2513763845601803,2,0,0,2,0.8965
1991716644473195_2513812265596961,0,1,0,1,0
1991716644473195_2513861842258670,1,0,0,1,0.4404
1991716644473195_2513863565591831,1,1,0,2,0.4404
1991716644473195_2513866655591522,2,0,0,2,1.1123
1991716644473195_2513878835590304,6,0,0,6,3.2452
1991716644473195_2513985402246314,14,11,0,25,6.6339
1991716644473195_2514004932244361,1,0,0,1,0.4404
1991716644473195_2514042382240616,4,0,0,4,1.6962
1991716644473195_2514046395573548,4,0,0,4,1.6824
1991716644473195_2514047938906727,3,1,0,4,2.0061
1991716644473195_2514083002236554,18,1,0,19,8.8557
1991716644473195_2514132898898231,18,6,1,25,9.242
1991716644473195_2514801128831408,2,0,0,2,0.8969
1991716644473195_2515604578751063,11,0,0,11,5.666
1991716644473195_2515625465415641,7,0,0,7,3.6862
1991716644473195_2515655462079308,21,4,0,25,11.8712
1991716644473195_2515728572071997,0,2,0,2,0
1991716644473195_2515824662062388,1,0,0,1,0.4404
1991716644473195_2515838415394346,1,0,0,1,0.4404
1991716644473195_2515931628718358,10,2,0,12,4.1701
1991716644473195_2516316355346552,1,0,0,1,0.4404
1991716644473195_2516317065346481,1,0,0,1,0.9433
1991716644473195_2516382915339896,1,1,0,2,0.0772
1991716644473195_2516445012000353,6,1,0,7,2.7891
1991716644473195_2516516568659864,23,2,0,25,11.2702
1991716644473195_2516526201992234,9,1,0,10,4.921
1991716644473195_2516749525303235,8,17,0,25,4.2362
1991716644473195_2517182515259936,3,0,0,3,1.3373
1991716644473195_2517186131926241,2,0,0,2,1.4804
1991716644473195_2517188208592700,1,5,0,6,0.0772
1991716644473195_2517190458592475,2,0,0,2,0.8969
1991716644473195_2517279615250226,11,1,1,13,4.8188
1991716644473195_2517377131907141,2,3,0,5,0.8234
1991716644473195_2517550315223156,3,0,0,3,1.4802
1991716644473195_2518029541841900,0,1,0,1,0
1991716644473195_2518030581841796,3,0,0,3,1.4424
1991716644473195_2518036558507865,2,1,0,3,0.8619
1991716644473195_2518080101836844,2,2,0,4,1.2833
1991716644473195_2518121078499413,1,0,0,1,0.7902
1991716644473195_2518127908498730,17,4,0,21,9.607
1991716644473195_2518203681824486,2,2,0,4,0.9331
1991716644473195_2518348861809968,0,1,0,1,0
1991716644473195_2518352738476247,2,3,0,5,0.9158
1991716644473195_2518934431751411,7,0,0,7,3.966
1991716644473195_2518936668417854,2,1,0,3,0.9394
1991716644473195_2518977778413743,1,0,0,1,0.6249
1991716644473195_2518997465078441,3,3,0,6,1.8235
1991716644473195_2519037861741068,5,1,0,6,2.2428
1991716644473195_2519067618404759,22,3,0,25,11.9778
1991716644473195_2519222811722573,2,1,0,3,1.1988
1991716644473195_2519247361720118,1,3,0,4,0.6249
1991716644473195_2519255331719321,18,4,0,22,10.0396
1991716644473195_2519347548376766,3,1,0,4,1.4868
1991716644473195_2519865108325010,20,5,0,25,11.7922
1991716644473195_2519939181650936,6,2,0,8,3.5635
1991716644473195_2520100131634841,16,9,0,25,7.2059
1991716644473195_2520230931621761,11,4,0,15,6.4105
1991716644473195_2520344238277097,13,4,0,17,8.2372
1991716644473195_2520670618244459,0,1,0,1,0
1991716644473195_2520708361574018,1,0,0,1,0.4754
1991716644473195_2520900861554768,1,0,0,1,0.4927
1991716644473195_2521665828144938,3,2,0,5,1.3212
1991716644473195_2521704638141057,1,0,0,1,0.4927
1991716644473195_2521710658140455,3,1,0,4,1.6579
1991716644473195_2521906984787489,1,1,0,2,0.8225
1991716644473195_2521921178119403,4,0,0,4,1.7427
1991716644473195_2522124701432384,1,0,0,1,0.6249
1991716644473195_2522430664735121,5,1,0,6,2.1453
1991716644473195_2522493294728858,3,0,0,3,1.6458
1991716644473195_2522554981389356,1,0,0,1,0.4754
1991716644473195_2523277601317094,4,2,0,6,1.8014
1991716644473195_2523391564639031,6,2,1,9,1.9536
1991716644473195_2523546097956911,2,0,0,2,1.191
1991716644473195_2523814301263424,6,6,1,13,2.4671
1991716644473195_2524282021216652,1,0,0,1,0.4215
1991716644473195_2524681097843411,2,2,0,4,0.5232
1991716644473195_2525423541102500,4,1,0,5,1.9622
1991716644473195_2525523934425794,1,0,0,1,0.4019
1991716644473195_2525612134416974,2,0,0,2,1.5264
1991716644473195_2526291684349019,3,1,0,4,1.7695
1991716644473195_2526328337678687,2,1,0,3,1.3647
1991716644473195_2526928850951969,6,2,0,8,3.0079
1991716644473195_2526958944282293,3,0,0,3,1.154
1991716644473195_2526966354281552,1,0,0,1,0.4404
1991716644473195_2527094670935387,0,2,0,2,0
1991716644473195_2527224224255765,20,2,3,25,9.212
1991716644473195_2527358080909046,8,5,0,13,3.3795
1991716644473195_2527832014194986,1,0,0,1,0.4404
1991716644473195_2527834494194738,1,0,0,1,0.4215
1991716644473195_2527835730861281,2,0,0,2,0.9158
1991716644473195_2527836350861219,0,1,0,1,0
1991716644473195_2527884687523052,1,0,0,1,0.4404
1991716644473195_2527892714188916,3,0,0,3,1.3562
1991716644473195_2527906880854166,15,7,3,25,5.3318
1991716644473195_2527918980852956,9,0,0,9,3.7586
1991716644473195_2528122994165888,6,6,2,14,1.5426
1991716644473195_2528179854160202,5,2,0,7,2.2295
1991716644473195_2528180100826844,0,1,0,1,0
1991716644473195_2528180377493483,8,17,0,25,3.5811
1991716644473195_2528194097492111,4,6,0,10,1.7616
1991716644473195_2528353060809548,0,1,0,1,0
1991716644473195_2528713280773526,3,4,0,7,1.4868
1991716644473195_2528760627435458,3,0,0,3,1.3373
1991716644473195_2528775844100603,3,0,0,3,1.3735
1991716644473195_2528826804095507,2,0,0,2,0.8808
1991716644473195_2528905677420953,5,0,0,5,3.1349
1991716644473195_2529127057398815,3,3,1,7,1.2093
1991716644473195_2529127294065458,4,2,0,6,1.6163
1991716644473195_2529127617398759,7,3,1,11,3.496
1991716644473195_2529537804024407,1,1,0,2,0.4404
1991716644473195_2529568944021293,15,2,0,17,7.0646
1991716644473195_2529577020687152,2,0,0,2,0.8808
1991716644473195_2529580527353468,1,0,0,1,0.4404
1991716644473195_2529581554020032,1,0,0,1,0.4404
1991716644473195_2529583774019810,1,0,0,1,0.4404
1991716644473195_2529587680686086,1,0,0,1,0.4404
1991716644473195_2529621030682751,1,0,0,1,0.4404
1991716644473195_2529699944008193,2,0,0,2,0.8808
1991716644473195_2529741420670712,2,0,0,2,0.8808
1991716644473195_2529856243992563,2,1,0,3,1.2368
1991716644473195_2529861000658754,3,0,0,3,1.7035
1991716644473195_2529940983984089,0,1,0,1,0
1991716644473195_2530731710571683,3,0,0,3,1.3212
1991716644473195_2530817977229723,2,0,0,2,1.5409
1991716644473195_2530819367229584,1,0,0,1,0.4404
1991716644473195_2530820733896114,2,0,0,2,1.2498
1991716644473195_2531165317194989,2,0,0,2,1.3194
1991716644473195_2531166150528239,1,0,0,1,0.4215
1991716644473195_2531166877194833,1,0,0,1,0.6997
1991716644473195_2531167603861427,0,1,0,1,0
1991716644473195_2531280947183426,14,5,1,20,6.8266
1991716644473195_2531324620512392,12,3,0,15,5.7947
1991716644473195_2531364853841702,7,3,0,10,4.7149
1991716644473195_2531387523839435,1,0,0,1,0.5994
1991716644473195_2531444170500437,0,1,0,1,0
1991716644473195_2531528007158720,3,0,0,3,1.5057
1991716644473195_2532046767106844,1,1,0,2,0.4404
1991716644473195_2532101553768032,1,0,0,1,0.9545
1991716644473195_2532214000423454,13,7,2,22,5.502
1991716644473195_2532252133752974,1,1,0,2,0.296
1991716644473195_2532282723749915,3,0,0,3,1.5407
1991716644473195_2532787913699396,1,0,0,1,0.4404
1991716644473195_2532858400359014,1,0,0,1,0.4404
1991716644473195_2532954210349433,10,1,0,11,4.7239
1991716644473195_2533696210275233,0,1,0,1,0
1991716644473195_2533716033606584,11,14,0,25,5.136
1991716644473195_2533812356930285,3,1,0,4,1.54
1991716644473195_2533871290257725,2,1,0,3,1.0464
1991716644473195_2534111546900366,7,0,1,8,2.7517
1991716644473195_2534328730211981,7,1,0,8,4.2873
1991716644473195_2534399060204948,17,2,0,19,9.7452
1991716644473195_2534489396862581,1,0,0,1,0.4404
1991716644473195_2534784233499764,2,1,0,3,1.0464
1991716644473195_2534993190145535,4,1,0,5,1.9795
1991716644473195_2535067000138154,1,0,0,1,0.4754
1991716644473195_2535363896775131,5,6,0,11,2.7119
1991716644473195_2535449450099909,18,7,0,25,9.1636
1991716644473195_2535464540098400,4,0,0,4,1.9461
1991716644473195_2535615876749933,3,0,0,3,1.0347
1991716644473195_2535779763400211,4,0,0,4,1.2873
1991716644473195_2535803670064487,3,1,0,4,1.5057
1991716644473195_2535832700061584,2,2,0,4,1.2243
1991716644473195_2536210320023822,1,0,0,1,0.7964
1991716644473195_2536412320003622,21,4,0,25,10.8642
1991716644473195_2536432700001584,1,2,0,3,0.6249
1991716644473195_2536465383331649,12,1,0,13,5.9826
1991716644473195_2536551189989735,5,2,0,7,2.1928
1991716644473195_2536555669989287,2,0,0,2,1.1576
1991716644473195_2536662009978653,2,2,0,4,0.7586
1991716644473195_2536986726612848,9,15,1,25,3.6602
1991716644473195_2537094186602102,1,0,0,1,0.4404
1991716644473195_2537128196598701,3,0,0,3,1.3023
1991716644473195_2537137083264479,3,2,1,6,1.1719
1991716644473195_2537236369921217,2,0,0,2,0.8808
1991716644473195_2537302746581246,3,0,0,3,2.4025
1991716644473195_2537303426581178,0,1,0,1,0
1991716644473195_2537485116563009,3,0,0,3,1.1737
1991716644473195_2537803129864541,1,2,0,3,0.4215
1991716644473195_2537803753197812,3,2,0,5,1.3735
1991716644473195_2537838263194361,1,0,0,1,0.8439
1991716644473195_2537839819860872,1,0,0,1,0.4754
1991716644473195_2537843979860456,5,1,0,6,2.2543
1991716644473195_2537920686519452,1,1,0,2,0.4404
1991716644473195_2537967136514807,5,0,0,5,2.272
1991716644473195_2538072169837637,19,6,0,25,10.3162
1991716644473195_2538106536500867,10,15,0,25,6.4209
1991716644473195_2538625749782279,21,2,0,23,10.6219
1991716644473195_2538695546441966,1,0,0,1,0.0772
1991716644473195_2538734406438080,1,0,0,1,0.4404
1991716644473195_2538748373103350,1,0,0,1,0.6908
1991716644473195_2538752486436272,21,4,0,25,10.2958
1991716644473195_2538785179766336,20,4,1,25,9.9017
1991716644473195_2538848669759987,12,4,1,17,7.1596
1991716644473195_2538852193092968,8,4,2,14,3.5068
1991716644473195_2538946023083585,18,5,2,25,7.8317
1991716644473195_2538949806416540,9,0,0,9,4.48
1991716644473195_2539117479733106,1,0,0,1,0.4404
1991716644473195_2539510623027125,1,0,0,1,0.4927
1991716644473195_2539642159680638,3,0,0,3,1.0682
1991716644473195_2539670569677797,3,1,0,4,1.3896
1991716644473195_2539676276343893,2,0,0,2,0.8619
1991716644473195_2539680849676769,2,3,1,6,0.9418
1991716644473195_2539681823010005,2,1,0,3,0.9158
1991716644473195_2539788046332716,9,2,0,11,3.6118
1991716644473195_2539797242998463,1,0,0,1,0.5267
1991716644473195_2539896339655220,1,0,0,1,0.743
1991716644473195_2539945576316963,1,0,0,1,0.6249
1991716644473195_2539949432983244,1,1,0,2,0.6908
1991716644473195_2539956092982578,2,0,0,2,0.9158
1991716644473195_2540005759644278,9,2,1,12,2.9518
1991716644473195_2540065409638313,3,0,0,3,1.2834
1991716644473195_2540107142967473,18,7,0,25,8.2889
1991716644473195_2540167549628099,1,0,0,1,0.4215
1991716644473195_2540446046266916,2,0,0,2,1.4155
1991716644473195_2540529972925190,10,2,0,12,4.8779
1991716644473195_2540611932916994,1,0,0,1,0.4215
1991716644473195_2540614746250046,8,1,0,9,3.5917
1991716644473195_2540631186248402,18,3,0,21,9.9304
1991716644473195_2540682742909913,7,3,0,10,3.5365
1991716644473195_2540685099576344,8,17,0,25,3.6967
1991716644473195_2540817139563140,4,0,0,4,1.5853
1991716644473195_2540860899558764,0,1,0,1,0
1991716644473195_2540899822888205,9,1,0,10,4.5007
1991716644473195_2541371289507725,2,0,0,2,0.9158
1991716644473195_2541384469506407,1,0,0,1,0.4404
1991716644473195_2541389832839204,1,0,0,1,0.4404
1991716644473195_2541487529496101,19,3,0,22,9.1318
1991716644473195_2541493762828811,3,0,0,3,1.3212
1991716644473195_2541588739485980,5,0,0,5,2.042
1991716644473195_2541610952817092,0,1,0,1,0
1991716644473195_2541649356146585,4,1,0,5,1.795
1991716644473195_2541673929477461,2,0,0,2,0.8808
1991716644473195_2541686382809549,1,0,0,1,0.4404
1991716644473195_2541751166136404,6,0,0,6,2.747
1991716644473195_2541819406129580,3,1,0,4,1.7489
1991716644473195_2541820626129458,10,2,1,13,5.2366
1991716644473195_2541839506127570,4,0,0,4,1.7345
1991716644473195_2542273772750810,7,2,0,9,3.7742
1991716644473195_2542274959417358,18,6,1,25,7.9532
1991716644473195_2542275882750599,4,2,0,6,1.6522
1991716644473195_2542380796073441,7,14,4,25,1.8925
1991716644473195_2542415066070014,8,0,0,8,3.5028
1991716644473195_2542429482735239,1,0,0,1,0.4404
1991716644473195_2542462416065279,7,17,1,25,1.6692
1991716644473195_2542529229391931,12,2,0,14,5.8633
1991716644473195_2542607536050767,1,0,0,1,0.4404
1991716644473195_2542608749383979,1,0,0,1,0.4404
1991716644473195_2542610122717175,1,0,0,1,0.4404
1991716644473195_2542660819378772,3,0,0,3,1.3212
1991716644473195_2542754839369370,4,2,0,6,1.8553
1991716644473195_2542854342692753,5,0,0,5,2.8987
1991716644473195_2542897726021748,19,6,0,25,8.3429
1991716644473195_2542901482688039,1,0,0,1,0.4404
1991716644473195_2543011686010352,1,0,0,1,0.4404
1991716644473195_2543342035977317,1,0,0,1,0.4404
1991716644473195_2543364115975109,1,0,0,1,0.4404
1991716644473195_2543366442641543,2,0,0,2,1.2368
1991716644473195_2543367415974779,1,0,0,1,0.4404
1991716644473195_2543368392641348,1,0,0,1,0.4404
1991716644473195_2543377355973785,2,14,1,17,0.7082
1991716644473195_2543387915972729,7,4,0,11,3.3184
1991716644473195_2543415915969929,16,7,2,25,6.0815
1991716644473195_2543480645963456,1,0,0,1,0.4404
1991716644473195_2543498092628378,5,7,0,12,2.0959
1991716644473195_2543520765959444,11,13,1,25,5.1061
1991716644473195_2543525325958988,1,1,0,2,0.4215
1991716644473195_2543753452602842,1,1,0,2,0.4215
1991716644473195_2543801272598060,3,0,0,3,1.3562
1991716644473195_2543808649263989,2,0,0,2,1.0773
1991716644473195_2543816839263170,1,0,0,1,0.296
1991716644473195_2543830009261853,6,1,0,7,3.7028
1991716644473195_2543892612588926,14,9,0,23,6.25
1991716644473195_2543925499252304,10,2,0,12,4.923
1991716644473195_2544233439221510,1,0,0,1,0.7906
1991716644473195_2544353402542847,2,0,0,2,0.7827
1991716644473195_2544357615875759,1,2,0,3,0.5719
1991716644473195_2544386199206234,0,1,0,1,0
1991716644473195_2544387029206151,2,6,0,8,0.8285
1991716644473195_2544417682536419,1,0,0,1,0.4215
1991716644473195_2544479132530274,8,5,0,13,4.6247
1991716644473195_2544604342517753,1,0,0,1,0.4404
1991716644473195_2544708392507348,2,0,0,2,1.0653
1991716644473195_2545128412465346,6,11,0,17,2.7997
1991716644473195_2545169465794574,1,0,0,1,0.8439
1991716644473195_2545170679127786,1,0,0,1,0.4754
1991716644473195_2545171465794374,0,1,0,1,0
1991716644473195_2545213749123479,1,0,0,1,0.4404
1991716644473195_2545263245785196,11,9,1,21,5.1365
1991716644473195_2545263829118471,4,1,0,5,1.8316
1991716644473195_2545381162440071,1,0,0,1,0.4404
1991716644473195_2545428312435356,1,0,0,1,0.4404
1991716644473195_2545447219100132,0,1,0,1,0
1991716644473195_2545485492429638,2,0,0,2,0.8808
1991716644473195_2545550265756494,2,0,0,2,0.8619
1991716644473195_2545623092415878,1,0,0,1,0.4404
1991716644473195_2545680432410144,8,4,1,13,3.4482
1991716644473195_2546074102370777,2,0,0,2,1.2848
1991716644473195_2546075712370616,3,1,0,4,1.154
1991716644473195_2546088805702640,16,8,1,25,6.5259
1991716644473195_2546093399035514,7,4,0,11,1.8841
1991716644473195_2546107045700816,19,6,0,25,9.0134
1991716644473195_2546120815699439,23,2,0,25,11.6171
1991716644473195_2546130415698479,1,0,0,1,0.4404
1991716644473195_2546151232363064,1,0,0,1,0.4404
1991716644473195_2546163975695123,1,0,0,1,0.4404
1991716644473195_2546368755674645,1,0,0,1,0.4404
1991716644473195_2546388212339366,7,1,0,8,3.0261
1991716644473195_2546788542299333,3,0,0,3,1.4988
1991716644473195_2546789188965935,1,2,0,3,0.4404
1991716644473195_2546846182293569,10,7,0,17,4.8196
1991716644473195_2546847415626779,0,1,0,1,0
1991716644473195_2546848228960031,0,2,0,2,0
1991716644473195_2546882758956578,6,1,0,7,2.6424
1991716644473195_2546905868954267,1,0,0,1,0.4754
1991716644473195_2546948428950011,1,0,0,1,0.4404
1991716644473195_2547031665608354,2,0,0,2,0.6904
1991716644473195_2547047678940086,1,0,0,1,0.4754
1991716644473195_2547216552256532,5,1,0,6,2.1264
1991716644473195_2547500018894852,2,2,0,4,0.8619
1991716644473195_2547642652213922,3,1,0,4,1.5502
1991716644473195_2547763318868522,0,0,1,1,-0.296
1991716644473195_2547792478865606,2,0,0,2,1.342
1991716644473195_2547859145525606,6,2,0,8,3.1484
1991716644473195_2547861372192050,10,0,0,10,4.8164
1991716644473195_2547882892189898,3,0,0,3,1.4402
1991716644473195_2547908148854039,18,5,0,23,8.7777
1991716644473195_2547922338852620,9,1,0,10,4.5316
1991716644473195_2548072918837562,1,1,0,2,0.5994
1991716644473195_2548095728835281,2,4,0,6,1.5404
1991716644473195_2548098618834992,1,0,0,1,0.4215
1991716644473195_2548148288830025,1,1,0,2,0.69
1991716644473195_2548190918825762,3,1,0,4,1.3272
1991716644473195_2548201882157999,1,1,0,2,0.296
1991716644473195_2548202402157947,4,3,1,8,1.6743
1991716644473195_2548235008821353,6,4,1,11,2.2606
1991716644473195_2548276528817201,22,3,0,25,7.9336
1991716644473195_2548673425444178,16,1,0,17,7.8565
1991716644473195_2548720372106150,8,11,0,19,3.873
1991716644473195_2548738498771004,9,3,0,12,4.7755
1991716644473195_2548758108769043,18,7,0,25,8.5545
1991716644473195_2548765682101619,2,1,0,3,1.0576
1991716644473195_2548776645433856,3,1,0,4,1.1721
1991716644473195_2548850215426499,5,0,0,5,2.2342
1991716644473195_2548881838756670,8,0,0,8,3.6443
1991716644473195_2548887358756118,6,0,0,6,3.1736
1991716644473195_2548964518748402,17,7,1,25,8.2743
1991716644473195_2549016808743173,1,1,0,2,0.3612
1991716644473195_2549050265406494,0,1,0,1,0
1991716644473195_2549095522068635,3,5,1,9,0.7379
1991716644473195_2549132498731604,1,0,0,1,0.4404
1991716644473195_2549455302032657,1,0,0,1,0.4754
1991716644473195_2549492255362295,1,0,0,1,0.4199
1991716644473195_2549527048692149,1,0,0,1,0.7964
1991716644473195_2549528728691981,2,0,0,2,1.3854
1991716644473195_2549603322017855,15,5,0,20,7.9282
1991716644473195_2549610485350472,1,0,0,1,0.3612
1991716644473195_2549675442010643,1,0,0,1,0.4404
1991716644473195_2549678915343629,7,0,0,7,4.0954
1991716644473195_2549700658674788,11,0,0,11,5.1462
1991716644473195_2549701208674733,7,0,0,7,3.0639
1991716644473195_2549710422007145,1,0,0,1,0.7783
1991716644473195_2549729138671940,1,0,0,1,0.4404
1991716644473195_2549801228664731,1,0,0,1,0.4927
1991716644473195_2549824078662446,1,0,0,1,0.3612
1991716644473195_2550067301971457,5,1,0,6,2.4651
1991716644473195_2550344055277115,2,2,0,4,0.8619
1991716644473195_2550452288599625,0,1,0,1,0
1991716644473195_2550452498599604,3,5,1,9,0.0631
1991716644473195_2550508081927379,2,2,0,4,0.9142
1991716644473195_2550550318589822,3,0,0,3,1.56
1991716644473195_2550576075253913,0,5,0,5,0
1991716644473195_2550577038587150,0,5,0,5,0
1991716644473195_2550628438582010,0,1,0,1,0
1991716644473195_2550643848580469,2,0,0,2,1.2152
1991716644473195_2550661435245377,1,0,0,1,0.3612
1991716644473195_2550693618575492,1,0,0,1,0.7096
1991716644473195_2550696055241915,1,0,0,1,0.4404
1991716644473195_2550797821898405,1,0,0,1,0.4404
1991716644473195_2550800688564785,1,0,0,1,0.4404
1991716644473195_2550845201893667,1,0,0,1,0.6908
1991716644473195_2551105791867608,1,0,0,1,0.4215
1991716644473195_2551210741857113,2,1,0,3,0.9158
1991716644473195_2551234871854700,1,0,0,1,0.4927
1991716644473195_2551311578513696,1,0,1,2,0.3289
1991716644473195_2551370265174494,10,0,0,10,4.9185
1991716644473195_2551375345173986,4,0,0,4,1.8139
1991716644473195_2551387398506114,9,0,0,9,4.6653
1991716644473195_2551411585170362,6,0,0,6,2.8391
1991716644473195_2551414668503387,1,0,0,1,0.4404
1991716644473195_2551422721835915,0,2,1,3,-0.0516
1991716644473195_2551480618496792,16,5,0,21,8.4449
1991716644473195_2551491115162409,0,1,0,1,0
1991716644473195_2551528155158705,0,3,0,3,0
1991716644473195_2551628315148689,2,1,0,3,0.8619
1991716644473195_2551648645146656,25,0,0,25,12.6324
1991716644473195_2551651245146396,7,0,0,7,3.9352
1991716644473195_2551736905137830,1,0,0,1,0.4215
1991716644473195_2551979961780191,1,1,0,2,0.4926
1991716644473195_2552000351778152,1,0,0,1,0.4404
1991716644473195_2552020641776123,1,0,0,1,0.4927
1991716644473195_2552120048432849,0,1,0,1,0
1991716644473195_2552122911765896,3,2,0,5,1.9008
1991716644473195_2552132231764964,2,0,0,2,1.0398
1991716644473195_2552138398431014,1,0,0,1,0.5859
1991716644473195_2552308071747380,2,1,0,3,0.9142
1991716644473195_2552508675060653,15,10,0,25,8.6779
1991716644473195_2552855515025969,1,0,0,1,0.6369
1991716644473195_2552886675022853,0,1,0,1,0
1991716644473195_2552952695016251,5,0,0,5,2.2543
1991716644473195_2553028025008718,1,0,0,1,0.4404
1991716644473195_2553033558341498,17,3,0,20,7.6264
1991716644473195_2553044688340385,3,0,0,3,1.4424
1991716644473195_2553061118338742,9,2,0,11,4.364
1991716644473195_2553125098332344,2,2,0,4,1.4185
1991716644473195_2553191101659077,2,0,0,2,0.9648
1991716644473195_2553406538304200,1,0,0,1,0.4927
1991716644473195_2553636461614541,0,1,0,1,0
1991716644473195_2553637434947777,0,4,0,4,0
1991716644473195_2553701031608084,3,0,0,3,1.3723
1991716644473195_2553721698272684,2,0,0,2,1.4538
1991716644473195_2553850038259850,1,0,0,1,0.4754
1991716644473195_2554009248243929,19,6,0,25,8.0328
1991716644473195_2554125034899017,1,0,0,1,0.7269
1991716644473195_2554485104863010,1,0,0,1,0.4215
1991716644473195_2554576634853857,8,1,0,9,4.1303
1991716644473195_2554811928163661,3,0,0,3,1.3546
1991716644473195_2554894141488773,1,0,0,1,0.7269
1991716644473195_2554968364814684,3,0,0,3,1.3184
1991716644473195_2554989724812548,1,1,0,2,0.4754
1991716644473195_2555465231431664,0,1,0,1,0
1991716644473195_2555466238098230,0,5,0,5,0
1991716644473195_2555486971429490,18,3,3,24,8.2553
1991716644473195_2555689318075922,1,0,0,1,0.4215
1991716644473195_2556220278022826,4,0,0,4,1.7565
1991716644473195_2556318874679633,2,1,0,3,1.0653
1991716644473195_2556342218010632,7,2,0,9,3.2227
1991716644473195_2556506537994200,0,2,0,2,0
1991716644473195_2556582081319979,15,9,1,25,6.4813
1991716644473195_2556592284652292,3,0,0,3,1.3023
1991716644473195_2556592507985603,2,3,0,5,1.434
1991716644473195_2556646074646913,1,0,0,1,0.4927
1991716644473195_2557125527932301,1,0,0,1,0.4404
1991716644473195_2557126281265559,1,0,0,1,0.4404
1991716644473195_2557127071265480,1,0,0,1,0.4215
1991716644473195_2557202504591270,1,0,0,1,0.4404
1991716644473195_2557382191239968,19,6,0,25,9.8524
1991716644473195_2557396144571906,1,0,0,1,0.6908
1991716644473195_2557881081190079,0,1,0,1,0
1991716644473195_2557935784517942,2,0,0,2,1.1171
1991716644473195_2557938961184291,1,0,0,1,0.5994
1991716644473195_2557981051180082,1,0,0,1,0.4404
1991716644473195_2557995777845276,13,1,0,14,6.4252
1991716644473195_2558040234507497,1,0,0,1,0.7269
1991716644473195_2558109974500523,2,2,0,4,0.8808
1991716644473195_2558113294500191,2,1,0,3,1.244
1991716644473195_2558285714482949,1,1,0,2,0.4754
1991716644473195_2558350217809832,11,1,0,12,6.4122
1991716644473195_2558353781142809,4,4,1,9,2.3758
1991716644473195_2558759131102274,1,6,0,7,0.4215
1991716644473195_2558760067768847,0,1,0,1,0
1991716644473195_2558842861093901,12,2,0,14,5.2434
1991716644473195_2558973077747546,3,1,0,4,1.0373
1991716644473195_2559236287721225,2,0,0,2,1.2243
1991716644473195_2559236511054536,5,1,0,6,3.2711
1991716644473195_2559566061021581,1,1,0,2,0.1157
1991716644473195_2559567221021465,0,3,0,3,0
1991716644473195_2559599244351596,8,0,0,8,3.9781
1991716644473195_2559725197672334,3,0,0,3,1.5202
1991716644473195_2559764191001768,3,0,0,3,1.3575
1991716644473195_2559883674323153,1,0,0,1,0.7717
1991716644473195_2559892160988971,1,0,0,1,0.4404
1991716644473195_2559972180980969,1,1,0,2,0.4404
1991716644473195_2560434724268048,10,1,0,11,4.4382
1991716644473195_2560495484261972,0,1,0,1,0
1991716644473195_2560497890928398,0,1,0,1,0
1991716644473195_2560561344255386,5,0,0,5,2.8072
1991716644473195_2560656930912494,1,0,0,1,0.4754
1991716644473195_2560823914229129,2,0,0,2,1.1512
1991716644473195_2560833190894868,9,0,0,9,4.9021
1991716644473195_2560869544224566,2,0,0,2,0.8619
1991716644473195_2560941454217375,2,0,0,2,1.1238
1991716644473195_2561116834199837,14,1,0,15,7.5194
1991716644473195_2561286994182821,0,1,0,1,0
1991716644473195_2561330827511771,2,0,0,2,1.1668
1991716644473195_2561378230840364,3,0,0,3,1.597
1991716644473195_2561401890837998,11,1,0,12,5.0679
1991716644473195_2561424327502421,0,1,0,1,0
1991716644473195_2561486694162851,1,0,0,1,0.4404
1991716644473195_2561686014142919,4,0,0,4,1.6872
1991716644473195_2561727454138775,3,1,1,5,1.6947
1991716644473195_2561839990794188,11,1,0,12,6.0511
1991716644473195_2562123540765833,1,0,0,1,0.4754
1991716644473195_2562130867431767,1,0,0,1,0.4215
1991716644473195_2562247377420116,1,0,0,1,0.5859
1991716644473195_2562247990753388,4,2,0,6,1.7966
1991716644473195_2562277014083819,9,1,0,10,4.3593
1991716644473195_2562322120745975,3,0,0,3,1.3023
1991716644473195_2562364860741701,1,0,0,1,0.4404
1991716644473195_2562411200737067,5,0,0,5,2.1642
1991716644473195_2562435674067953,1,0,0,1,0.4754
1991716644473195_2562461487398705,3,1,0,4,1.3023
1991716644473195_2562481900729997,2,0,0,2,0.8969
1991716644473195_2562550044056516,1,0,0,1,0.4404
1991716644473195_2562553200722867,15,0,0,15,6.9557
1991716644473195_2562564387388415,1,0,0,1,0.9798
1991716644473195_2562659644045556,1,1,0,2,0.4215
1991716644473195_2563010814010439,1,0,0,1,0.4404
1991716644473195_2563152807329573,3,3,0,6,1.2834
1991716644473195_2563181353993385,2,0,0,2,0.843
1991716644473195_2563192880658899,2,0,0,2,0.9443
1991716644473195_2563220647322789,6,0,1,7,2.6427
1991716644473195_2563251240653063,1,0,0,1,0.4927
1991716644473195_2563311053980415,24,1,0,25,12.4397
1991716644473195_2563397600638427,3,0,0,3,1.7038
1991716644473195_2563421340636053,3,1,0,4,1.242
1991716644473195_2563424903969030,0,1,0,1,0
1991716644473195_2563505183961002,1,0,0,1,0.4404
1991716644473195_2563507117294142,1,0,0,1,0.4404
1991716644473195_2563592033952317,11,4,0,15,5.4955
1991716644473195_2563823103929210,2,0,0,2,0.843
1991716644473195_2563873833924137,14,0,0,14,7.343
1991716644473195_2563967437248110,2,0,0,2,1.0328
1991716644473195_2563967780581409,1,1,0,2,0.4404
1991716644473195_2563998357245018,5,0,0,5,2.7313
1991716644473195_2564007973910723,11,2,2,15,5.9122
1991716644473195_2564009080577279,5,1,0,6,2.676
1991716644473195_2564079827236871,1,0,0,1,0.4939
1991716644473195_2564118627232991,1,0,0,1,0.9648
1991716644473195_2564215203890000,3,0,0,3,1.3373
1991716644473195_2564216527223201,3,0,0,3,1.4613
1991716644473195_2564263320551855,2,0,0,2,1.0398
1991716644473195_2564588803852640,6,1,0,7,2.6491
1991716644473195_2564692497175604,1,0,0,1,0.4754
1991716644473195_2564712240506963,3,2,0,5,1.5427
1991716644473195_2564731097171744,0,1,0,1,0
1991716644473195_2564732243838296,0,1,0,1,0
1991716644473195_2564758287169025,1,0,0,1,0.4215
1991716644473195_2564774407167413,1,0,0,1,0.4404
1991716644473195_2564777903833730,19,2,1,22,8.8918
1991716644473195_2564808250497362,3,0,0,3,1.3184
1991716644473195_2564861460492041,17,2,0,19,9.0797
1991716644473195_2564918793819641,7,0,0,7,3.4553
1991716644473195_2564923437152510,1,1,0,2,0.4404
1991716644473195_2564924670485720,1,1,0,2,0.5994
1991716644473195_2564959113815609,2,0,0,2,0.843
1991716644473195_2565450030433184,2,1,0,3,1.3459
1991716644473195_2565457347099119,0,2,0,2,0
1991716644473195_2565458780432309,0,5,0,5,0
1991716644473195_2565514600426727,7,0,0,7,3.1313
1991716644473195_2565519723759548,2,0,0,2,1.0209
1991716644473195_2565563853755135,3,2,0,5,1.2203
1991716644473195_2565584530419734,1,0,0,1,0.4404
1991716644473195_2565633330414854,5,1,0,6,2.7261
1991716644473195_2565634347081419,2,0,0,2,0.8619
1991716644473195_2565663250411862,3,0,0,3,1.8385
1991716644473195_2565723783739142,8,4,0,12,4.2978
1991716644473195_2565761363735384,4,0,0,4,1.7042
1991716644473195_2565794523732068,2,1,0,3,1.1757
1991716644473195_2565862553725265,4,0,0,4,2.447
1991716644473195_2565907873720733,4,0,0,4,2.0732
1991716644473195_2566233207021533,5,1,0,6,2.9443
1991716644473195_2566273103684210,0,4,0,4,0
1991716644473195_2566274140350773,0,4,0,4,0
1991716644473195_2566286620349525,15,6,1,22,7.9856
1991716644473195_2566289347015919,1,0,0,1,0.7783
1991716644473195_2566317903679730,10,3,0,13,5.4945
1991716644473195_2566352810342906,4,2,0,6,1.8112
1991716644473195_2566395043672016,3,0,0,3,1.3373
1991716644473195_2566477363663784,2,1,0,3,0.8969
1991716644473195_2566535483657972,3,0,0,3,1.3023
1991716644473195_2566547030323484,1,0,0,1,0.4404
1991716644473195_2566614633650057,12,4,3,19,5.3011
1991716644473195_2566704593641061,1,0,0,1,0.5994
1991716644473195_2566975933613927,2,0,0,2,1.1356
1991716644473195_2566991433612377,1,0,0,1,0.4215
1991716644473195_2567077310270456,0,2,0,2,0
1991716644473195_2567078693603651,0,2,0,2,0
1991716644473195_2567169640261223,1,1,0,2,0.4215
1991716644473195_2567183963593124,6,1,0,7,2.7986
1991716644473195_2567239410254246,6,0,0,6,2.8052
1991716644473195_2567246670253520,11,2,0,13,5.7087
1991716644473195_2567267340251453,2,0,0,2,1.4448
1991716644473195_2567315983579922,17,8,0,25,9.1723
1991716644473195_2567335000244687,8,1,0,9,4.255
1991716644473195_2567625930215594,1,0,0,1,0.4927
1991716644473195_2567844940193693,2,1,0,3,1.2915
1991716644473195_2567879393523581,0,3,0,3,0
1991716644473195_2567880410190146,0,7,0,7,0
1991716644473195_2568006346844219,1,0,0,1,0.4754
1991716644473195_2568020626842791,3,2,0,5,0.888
1991716644473195_2568025623508958,1,0,0,1,0.6249
1991716644473195_2568061453505375,6,3,0,9,3.1548
1991716644473195_2568061716838682,2,0,0,2,0.8619
1991716644473195_2568107336834120,5,2,0,7,2.3295
1991716644473195_2568222296822624,1,3,0,4,0.296
1991716644473195_2568590216785832,1,0,0,1,0.8176
1991716644473195_2568639253447595,1,0,0,1,0.4215
1991716644473195_2568710086773845,6,1,0,7,3.7251
1991716644473195_2568745913436929,0,1,0,1,0
1991716644473195_2568783333433187,2,0,0,2,1.0123
1991716644473195_2568796366765217,22,3,0,25,12.5994
1991716644473195_2568825440095643,24,1,0,25,11.3319
1991716644473195_2568853023426218,9,2,0,11,4.1614
1991716644473195_2568889970089190,0,2,0,2,0
1991716644473195_2568891016755752,0,6,0,6,0
1991716644473195_2569037176741136,2,0,0,2,1.0803
1991716644473195_2569136020064585,0,1,0,1,0
1991716644473195_2569222516722602,8,0,0,8,4.0978
1991716644473195_2569592963352224,1,0,0,1,0.4215
1991716644473195_2569637266681127,8,0,0,8,3.5554
1991716644473195_2569676443343876,2,1,0,3,1.0773
1991716644473195_2569676903343830,1,1,0,2,0.4404
1991716644473195_2569688563342664,0,2,0,2,0
1991716644473195_2569690456675808,0,2,0,2,0
1991716644473195_2569694503342070,1,0,0,1,0.8519
1991716644473195_2569704423341078,1,0,0,1,0.4215
1991716644473195_2569745640003623,2,0,0,2,0.9154
1991716644473195_2569749613336559,2,0,0,2,0.9331
1991716644473195_2570016719976515,5,2,0,7,2.3861
1991716644473195_2570054016639452,1,0,0,1,0.5994
1991716644473195_2570083229969864,20,5,0,25,8.5157
1991716644473195_2570090266635827,3,0,0,3,1.4615
1991716644473195_2570173779960809,6,0,1,7,2.6302
1991716644473195_2570275673283953,3,0,0,3,1.8703
1991716644473195_2570626919915495,0,4,0,4,0
1991716644473195_2570649036579950,3,0,0,3,1.4613
1991716644473195_2570714739906713,0,4,0,4,0
1991716644473195_2570913996553454,1,0,0,1,0.4215
1991716644473195_2570949679883219,1,0,0,1,0.5994
1991716644473195_2571008799877307,19,6,0,25,8.6768
1991716644473195_2571021286542725,16,9,0,25,8.5565
1991716644473195_2571029933208527,3,1,0,4,1.3546
1991716644473195_2571043376540516,4,0,0,4,2.0995
1991716644473195_2571084759869711,1,0,0,1,0.4754
1991716644473195_2571315629846624,3,2,0,5,1.2231
1991716644473195_2571327939845393,0,1,0,1,0
1991716644473195_2571371223174398,17,6,2,25,8.1565
1991716644473195_2571375333173987,0,2,0,2,0
1991716644473195_2571404579837729,4,2,0,6,0.913
1991716644473195_2571565536488300,3,0,0,3,1.3023
1991716644473195_2572354809742706,1,0,0,1,0.2732
1991716644473195_2572528803058640,1,0,0,1,0.4754
1991716644473195_2572633656381488,10,2,0,12,5.5228
1991716644473195_2572953286349525,3,1,0,4,1.6606
1991716644473195_2573143189663868,21,4,0,25,12.5161
1991716644473195_2573189829659204,8,1,0,9,3.6101
1991716644473195_2573235169654670,5,2,0,7,2.3246
1991716644473195_2573429089635278,5,0,0,5,2.111
1991716644473195_2573738649604322,1,0,0,1,0.4754
1991716644473195_2573858362925684,1,0,0,1,0.4648
1991716644473195_2573929416251912,1,0,0,1,0.4215
1991716644473195_2573959412915579,1,1,0,2,0.0772
1991716644473195_2573959979582189,7,2,0,9,3.4795
1991716644473195_2574074006237453,2,1,0,3,1.0653
1991716644473195_2574085282902992,2,1,0,3,0.592
1991716644473195_2574123962899124,2,1,0,3,1.3062
1991716644473195_2574168936227960,2,0,0,2,0.8808
1991716644473195_2574217949556392,0,0,1,1,-0.296
1991716644473195_2574796349498552,1,0,0,1,0.4215
1991716644473195_2574870126157841,1,0,0,1,0.4215
1991716644473195_2574898929488294,2,1,0,3,0.6572
1991716644473195_2574914986153355,23,2,0,25,12.5104
1991716644473195_2575046009473586,0,0,1,1,-0.296
1991716644473195_2575107816134072,2,1,0,3,0.8969
1991716644473195_2576320149346172,2,0,0,2,0.5176
1991716644473195_2576493402662180,0,1,1,2,-0.296
1991716644473195_2576543679323819,1,0,0,1,0.4215
1991716644473195_2576787449299442,19,3,0,22,9.9304
1991716644473195_2577153692596151,2,0,0,2,0.9854
1991716644473195_2577185679259619,0,3,0,3,0
1991716644473195_2577237839254403,1,0,0,1,0.4927
1991716644473195_2577348129243374,3,0,0,3,1.7168
1991716644473195_2577417309236456,15,2,0,17,7.7808
1991716644473195_2577474505897403,7,0,0,7,3.2229
1991716644473195_2577722575872596,0,1,0,1,0
1991716644473195_2578216609156526,0,2,0,2,0
1991716644473195_2578308029147384,2,3,1,6,0.7438
1991716644473195_2578457689132418,9,15,1,25,2.2496
1991716644473195_2578468305798023,0,1,0,1,0
1991716644473195_2578468445798009,3,0,0,3,1.8855
1991716644473195_2578805349097652,1,0,0,1,0.8176
1991716644473195_2578918649086322,1,0,0,1,0.5994
1991716644473195_2578933502418170,0,1,0,1,0
1991716644473195_2578972742414246,6,1,0,7,2.8085
1991716644473195_2578981802413340,3,0,0,3,1.5218
1991716644473195_2579002315744622,1,0,0,1,0.4404
1991716644473195_2579038635740990,1,0,0,1,0.4215
1991716644473195_2579124489065738,16,0,0,16,7.8139
1991716644473195_2579148612396659,21,2,0,23,9.8241
1991716644473195_2579805615664292,1,0,0,1,0.4754
1991716644473195_2579830682328452,2,0,0,2,1.1003
1991716644473195_2579830888995098,1,0,0,1,0.4754
1991716644473195_2579863912325129,8,2,0,10,3.7426
1991716644473195_2580244618953725,4,2,0,6,2.0427
1991716644473195_2580577248920462,0,1,0,1,0
1991716644473195_2580599122251608,1,0,0,1,0.8176
1991716644473195_2580668122244708,9,0,1,10,4.2069
1991716644473195_2580767352234785,0,0,1,1,-0.0572
1991716644473195_2580865512224969,1,1,0,2,0.4404
1991716644473195_2581550558823131,1,0,0,1,0.6369
1991716644473195_2581745738803613,4,0,0,4,1.9295
1991716644473195_2581760015468852,1,0,0,1,0.4754
1991716644473195_2581772182134302,1,0,0,1,0.4926
1991716644473195_2581879252123595,3,1,0,4,1.2169
1991716644473195_2582355648742622,7,2,0,9,3.0112
1991716644473195_2582474975397356,4,0,0,4,2.4422
1991716644473195_2582522418725945,3,1,0,4,1.7556
1991716644473195_2582605935384260,1,0,0,1,0.3612
1991716644473195_2582620985382755,0,1,0,1,0
1991716644473195_2582726652038855,8,9,2,19,2.7127
1991716644473195_2582733835371470,3,1,0,4,1.9702
1991716644473195_2582738122037708,1,1,0,2,0.4404
1991716644473195_2583173751994145,5,2,0,7,2.7966
1991716644473195_2583198475325006,7,1,0,8,3.4698
1991716644473195_2583514075293446,7,1,0,8,3.4071
1991716644473195_2583677358610451,1,0,0,1,0.4927
1991716644473195_2584279225216931,2,0,0,2,0.8619
1991716644473195_2584332688544918,2,0,0,2,0.8808
1991716644473195_2584838825160971,1,1,0,2,0.4404
1991716644473195_2584916131819907,1,0,0,1,0.4404
1991716644473195_2584951911816329,1,0,0,1,0.296
1991716644473195_2584984851813035,1,1,0,2,0.3612
1991716644473195_2584998285145025,4,0,0,4,1.7761
1991716644473195_2585142991797221,5,6,0,11,3.153
1991716644473195_2585145698463617,1,0,0,1,0.4404
1991716644473195_2585317758446411,2,0,0,2,1.0653
1991716644473195_2585686531742867,1,0,0,1,0.4404
1991716644473195_2585874951724025,5,2,1,8,2.6224
1991716644473195_2586295335015320,20,5,0,25,10.8853
1991716644473195_2586338658344321,4,0,0,4,1.6257
1991716644473195_2586442731667247,3,14,0,17,1.3367
1991716644473195_2586776294967224,1,2,0,3,0.4404
1991716644473195_2586864601625060,1,1,0,2,0.4215
1991716644473195_2587234248254762,21,4,0,25,11.6344
1991716644473195_2587569188221268,15,5,0,20,6.6722
1991716644473195_2589003778077809,17,3,0,20,8.3178
1991716644473195_2589528581358662,12,5,0,17,7.2799
1991716644473195_2589660514678802,1,0,0,1,0.4754
1991716644473195_2591473394497514,5,0,0,5,2.5521
1991716644473195_2591496861161834,3,1,0,4,1.3212
1991716644473195_2592500011061519,15,4,0,19,6.7295
1991716644473195_2592690901042430,0,1,0,1,0
1991716644473195_2593035951007925,14,10,1,25,5.7388
1991716644473195_2593173890994131,6,0,0,6,2.5275
1991716644473195_2593396810971839,0,2,0,2,0
1991716644473195_2593809000930620,4,1,0,5,2.1467
1991716644473195_2594029974241856,2,0,0,2,1.2498
1991716644473195_2594282507549936,1,0,0,1,0.4215
1991716644473195_2594315300879990,1,0,0,1,0.4215
1991716644473195_2594684904176363,7,1,0,8,3.045
1991716644473195_2594864037491783,11,6,1,18,3.7654
1991716644473195_2595716820739838,5,0,0,5,2.2365
1991716644473195_2595811047397082,3,1,0,4,1.3357
1991716644473195_2595831887394998,1,0,0,1,0.5859
1991716644473195_2595855734059280,3,0,0,3,1.3023
1991716644473195_2595939744050879,20,1,0,21,10.1234
1991716644473195_2596123120699208,24,1,0,25,11.621
1991716644473195_2596486437329543,1,1,0,2,0.4754
1991716644473195_2596605697317617,2,0,0,2,1.0653
1991716644473195_2596607227317464,12,4,1,17,5.1596
1991716644473195_2596769287301258,6,2,0,8,2.5238
1991716644473195_2596813980630122,4,2,0,6,1.686
1991716644473195_2596907550620765,4,0,0,4,1.7777
1991716644473195_2596967883948065,1,0,0,1,0.4404
1991716644473195_2596972147280972,1,0,0,1,0.4404
1991716644473195_2597432853901568,1,0,0,1,0.4404
1991716644473195_2597469690564551,5,4,0,9,2.7283
1991716644473195_2597490673895786,1,0,0,1,0.4404
1991716644473195_2597491623895691,5,0,0,5,2.8825
1991716644473195_2597615233883330,3,4,0,7,2.0999
1991716644473195_2597621533882700,0,1,0,1,0
1991716644473195_2597682863876567,2,0,0,2,1.0464
1991716644473195_2597825157195671,2,0,1,3,0.2591
1991716644473195_2598359757142211,2,1,0,3,0.7364
1991716644473195_2598391670472353,2,0,0,2,0.9508
1991716644473195_2598426123802241,4,0,0,4,1.7049
1991716644473195_2598785090433011,1,2,0,3,0.4767
1991716644473195_2599124767065710,9,0,0,9,5.3848
1991716644473195_2599143770397143,3,1,0,4,1.6052
1991716644473195_2599208527057334,4,0,0,4,2.8778
1991716644473195_2599237393721114,1,2,0,3,0.4404
1991716644473195_2599245557053631,3,0,0,3,1.4852
1991716644473195_2599333497044837,1,0,0,1,0.7269
1991716644473195_2599417197036467,2,0,0,2,0.8969
1991716644473195_2599447220366798,2,1,0,3,0.8808
1991716644473195_2599542873690566,11,14,0,25,5.534
1991716644473195_2600078166970370,8,1,0,9,3.7913
1991716644473195_2600266723618181,4,9,1,14,1.1374
1991716644473195_2600275150284005,2,0,0,2,1.0079
1991716644473195_2600295190282001,4,0,0,4,1.7427
1991716644473195_2600420336936153,1,0,0,1,0.6249
1991716644473195_2600511803593673,3,0,0,3,1.4368
1991716644473195_2600995526878634,0,0,1,1,-0.296
1991716644473195_2601168793527974,7,0,0,7,3.6846
1991716644473195_2601213286856858,17,8,0,25,5.2186
1991716644473195_2601213796856807,23,2,0,25,13.3755
1991716644473195_2601238350187685,2,0,0,2,1.0398
1991716644473195_2601273210184199,0,0,1,1,-0.0258
1991716644473195_2601371010174419,7,2,0,9,3.4416
1991716644473195_2601470556831131,2,2,0,4,0.8016
1991716644473195_2601471316831055,8,3,0,11,3.3029
1991716644473195_2601471516831035,2,7,0,9,1.1457
1991716644473195_2601489670162553,11,13,1,25,3.4862
1991716644473195_2601588390152681,3,5,0,8,1.3161
1991716644473195_2601848550126665,1,1,0,2,0.3182
1991716644473195_2601905560120964,3,0,0,3,1.277
1991716644473195_2602058163439037,23,2,0,25,12.0862
1991716644473195_2602141583430695,4,0,0,4,1.83
1991716644473195_2602915670019953,3,0,0,3,1.4781
1991716644473195_2603004010011119,12,2,0,14,6.7785
1991716644473195_2603604303284423,1,12,1,14,-0.2188
1991716644473195_2603612689950251,5,1,0,6,2.5219
1991716644473195_2603744209937099,7,1,0,8,3.8009
1991716644473195_2603803973264456,1,0,0,1,0.4404
1991716644473195_2603809779930542,8,2,1,11,3.7168
1991716644473195_2603877786590408,3,0,0,3,1.7982
1991716644473195_2603892583255595,4,0,0,4,2.6
1991716644473195_2604000353244818,6,7,1,14,2.1895
1991716644473195_2604031446575042,4,3,0,7,1.8138
1991716644473195_2604141666564020,8,6,0,14,3.0306
1991716644473195_2604445899866930,1,1,0,2,0.4019
1991716644473195_2604501839861336,2,12,0,14,1.0307
1991716644473195_2604524806525706,0,1,0,1,0
1991716644473195_2604525626525624,21,4,0,25,10.2908
1991716644473195_2604546309856889,1,0,0,1,0.4404
1991716644473195_2604552556522931,10,1,0,11,4.7461
1991716644473195_2604555753189278,8,0,0,8,4.317
1991716644473195_2604567993188054,7,1,0,8,3.8762
1991716644473195_2604590403185813,2,0,1,3,1.4497
1991716644473195_2604594746518712,8,0,1,9,4.4498
1991716644473195_2604605496517637,10,14,1,25,4.441
1991716644473195_2604686119842908,4,0,0,4,2.0672
1991716644473195_2604751949836325,2,3,2,7,0.6783
1991716644473195_2604990489812471,3,0,0,3,1.5093
1991716644473195_2605444139767106,3,0,0,3,1.4084
1991716644473195_2605487263096127,6,4,0,10,2.4791
1991716644473195_2605583783086475,2,0,0,2,1.0209
1991716644473195_2605656769745843,5,0,0,5,2.7209
1991716644473195_2605666843078169,1,0,0,1,0.8491
1991716644473195_2605737973071056,3,3,0,6,2.1578
1991716644473195_2605760509735469,5,2,0,7,2.7112
1991716644473195_2605869083057945,15,10,0,25,7.4758
1991716644473195_2605917853053068,0,1,0,1,0
1991716644473195_2606399616338225,8,0,0,8,3.8511
1991716644473195_2606401069671413,0,0,1,1,-0.1697
1991716644473195_2606404866337700,1,0,0,1,0.6908
1991716644473195_2606408949670625,13,3,0,16,7.0549
1991716644473195_2606434539668066,2,1,0,3,0.8808
1991716644473195_2606444679667052,1,0,0,1,0.4215
1991716644473195_2606475809663939,3,10,0,13,1.0357
1991716644473195_2606479152996938,2,1,0,3,0.9158
1991716644473195_2606480082996845,1,1,0,2,0.3612
1991716644473195_2606609292983924,1,0,0,1,0.4404
1991716644473195_2606640516314135,5,3,0,8,2.8798
1991716644473195_2606704302974423,14,4,0,18,7.8264
1991716644473195_2606761572968696,0,1,0,1,0
1991716644473195_2606876142957239,1,2,0,3,0.9782
1991716644473195_2606888229622697,0,1,1,2,-0.296
1991716644473195_2606955946282592,15,10,0,25,7.9877
1991716644473195_2607413539570166,10,5,0,15,6.3298
1991716644473195_2607447532900100,11,12,2,25,4.181
1991716644473195_2607483019563218,4,8,0,12,1.9362
1991716644473195_2607486576229529,0,1,0,1,0
1991716644473195_2607511682893685,18,2,0,20,7.9649
1991716644473195_2607551512889702,0,1,0,1,0
1991716644473195_2607563806221806,5,6,0,11,2.1831
1991716644473195_2607578352887018,1,0,0,1,0.4404
1991716644473195_2607684219543098,3,7,0,10,1.7971
1991716644473195_2607689292875924,1,2,0,3,0.8531
1991716644473195_2608196356158551,3,4,0,7,1.9856
1991716644473195_2608242152820638,1,1,0,2,0.4215
1991716644473195_2608259889485531,9,1,0,10,4.794
1991716644473195_2608282486149938,1,0,0,1,0.9782
1991716644473195_2608284092816444,6,2,0,8,3.1684
1991716644473195_2608316006146586,1,2,0,3,0.4927
1991716644473195_2608338442811009,2,0,0,2,0.8619
1991716644473195_2608446522800201,3,1,0,4,1.3373
1991716644473195_2608447986133388,0,6,1,7,-0.2023
1991716644473195_2608482156129971,1,2,0,3,0.7096
1991716644473195_2608590286119158,0,2,0,2,0
1991716644473195_2608591796119007,0,1,0,1,0
1991716644473195_2608629839448536,1,0,0,1,0.6908
1991716644473195_2608636036114583,5,2,0,7,2.2101
1991716644473195_2608679286110258,10,12,0,22,4.9241
1991716644473195_2608689396109247,1,1,0,2,0.871
1991716644473195_2608708109440709,1,0,0,1,0.6597
1991716644473195_2608709852773868,3,2,0,5,1.3735
1991716644473195_2609072462737607,1,1,0,2,0.4939
1991716644473195_2609221939389326,5,4,1,10,2.1515
1991716644473195_2609251346053052,3,1,0,4,1.7117
1991716644473195_2609270859384434,1,7,0,8,0.4404
1991716644473195_2609315182713335,1,3,0,4,0.4404
1991716644473195_2609334806044706,1,2,0,3,0.4404
1991716644473195_2609339296044257,19,6,0,25,8.6912
1991716644473195_2609352879376232,7,4,0,11,4.273
1991716644473195_2609478576030329,2,4,0,6,0.8619
1991716644473195_2609618972682956,2,2,0,4,0.7364
1991716644473195_2609641082680745,1,0,0,1,0.4215
1991716644473195_2609646192680234,10,5,0,15,5.4357
1991716644473195_2609661572678696,4,4,0,8,2.3584
1991716644473195_2609929692651884,22,3,0,25,11.9392
1991716644473195_2609997919311728,0,4,0,4,0
1991716644473195_2610064265971760,4,2,1,7,1.5707
1991716644473195_2610136805964506,2,2,0,4,1.2675
1991716644473195_2610139445964242,4,15,0,19,1.7616
1991716644473195_2610139672630886,1,3,0,4,0.0772
1991716644473195_2610198705958316,2,0,0,2,1.187
1991716644473195_2610381589273361,1,2,0,3,0.4404
1991716644473195_2610382719273248,1,0,0,1,0.4404
1991716644473195_2610382732606580,3,7,1,11,1.3427
1991716644473195_2610393805938806,1,7,0,8,0.4404
1991716644473195_2610434089268111,4,20,1,25,1.8803
1991716644473195_2610446799266840,11,13,1,25,5.3397
1991716644473195_2610452725932914,7,7,0,14,3.7666
1991716644473195_2610502872594566,2,15,0,17,0.8808
1991716644473195_2610808349230685,2,0,0,2,0.8619
1991716644473195_2610835442561309,1,6,0,7,0.4404
1991716644473195_2610848532560000,2,15,0,17,0.8808
1991716644473195_2610867385891448,2,5,0,7,1.3211
1991716644473195_2610984392546414,0,25,0,25,0
1991716644473195_2610996132545240,0,2,0,2,0
1991716644473195_2611026912542162,5,20,0,25,2.2893
1991716644473195_2611040112540842,0,25,0,25,0
1991716644473195_2611046822540171,2,4,0,6,1.0464
1991716644473195_2611131539198366,2,5,0,7,0.8968
1991716644473195_2611132305864956,1,5,0,6,0.0516
1991716644473195_2611149915863195,1,23,1,25,-0.0468
1991716644473195_2611224872522366,0,1,0,1,0
1991716644473195_2611368022508051,1,1,0,2,0.4215
1991716644473195_2611575249153995,1,1,0,2,0.4754
1991716644473195_2611708489140671,8,17,0,25,3.6445
1991716644473195_2611729675805219,0,9,0,9,0
1991716644473195_2611761642468689,0,11,0,11,0
1991716644473195_2611811785797008,1,19,0,20,0.4404
1991716644473195_2611821225796064,1,1,0,2,0.4754
1991716644473195_2611883149123205,4,20,0,24,1.866
1991716644473195_2612179632426890,1,9,0,10,0.6249
1991716644473195_2612489225729264,4,0,0,4,1.8662
1991716644473195_2612536469057873,2,1,0,3,0.9331
1991716644473195_2612567585721428,0,0,1,1,-0.5267
1991716644473195_2612570149054505,0,5,0,5,0
1991716644473195_2612625879048932,13,12,0,25,6.2942
1991716644473195_2612633455714841,3,22,0,25,1.6902
1991716644473195_2612633789048141,2,23,0,25,1.0653
1991716644473195_2612643462380507,0,25,0,25,0
1991716644473195_2612647249046795,1,24,0,25,0.4404
1991716644473195_2612665019045018,15,10,0,25,7.5931
1991716644473195_2612667032378150,2,23,0,25,0.5699
1991716644473195_2612684819043038,2,0,0,2,0.9508
1991716644473195_2612721299039390,2,23,0,25,0.8808
1991716644473195_2612721445706042,0,22,0,22,0
1991716644473195_2612740442370809,1,24,0,25,0.4404
1991716644473195_2612766772368176,2,12,0,14,0.736
1991716644473195_2613056155672571,1,15,0,16,0.7579
1991716644473195_2613117162333137,3,20,2,25,1.1911
1991716644473195_2613372522307601,1,24,0,25,0.4404
1991716644473195_2613375985640588,0,11,0,11,0
1991716644473195_2613456475632539,1,24,0,25,0.0258
1991716644473195_2613462382298615,1,12,0,13,0.6467
1991716644473195_2613504258961094,1,24,0,25,0.7579
1991716644473195_2613549258956594,3,17,0,20,1.3562
1991716644473195_2613550442289809,1,24,0,25,0.4404
1991716644473195_2613575228953997,6,19,0,25,2.7124
1991716644473195_2613576822287171,1,24,0,25,0.4927
1991716644473195_2613588255619361,7,18,0,25,3.3023
1991716644473195_2613590132285840,11,14,0,25,5.5241
1991716644473195_2613614918950028,0,25,0,25,0
1991716644473195_2613615008950019,3,22,0,25,1.154
1991716644473195_2613618805616306,0,24,1,25,-0.1027
1991716644473195_2613641665614020,0,23,2,25,-0.2054
1991716644473195_2613666975611489,1,23,1,25,0.1444
1991716644473195_2613707118940808,0,4,0,4,0
1991716644473195_2613709595607227,5,19,1,25,2.4147
1991716644473195_2613771848934335,1,24,0,25,0.4404
1991716644473195_2613836278927892,4,18,3,25,1.8657
1991716644473195_2613869245591262,7,17,1,25,3.5766
1991716644473195_2613873972257456,9,15,1,25,4.6153
1991716644473195_2614188522226001,4,21,0,25,1.8661
1991716644473195_2614292162215637,2,23,0,25,0.8016
1991716644473195_2614298235548363,1,24,0,25,0.4215
1991716644473195_2614308038880716,3,20,2,25,1.2369
1991716644473195_2614327018878818,1,24,0,25,0.6249
1991716644473195_2614344018877118,3,21,1,25,1.0513
1991716644473195_2614392255538961,1,23,1,25,0.4337
1991716644473195_2614454415532745,0,9,0,9,0
1991716644473195_2614463348865185,0,25,0,25,0
1991716644473195_2614471728864347,0,7,0,7,0
1991716644473195_2614478558863664,1,24,0,25,0.4404
1991716644473195_2614545168857003,0,25,0,25,0
1991716644473195_2614585825519604,0,25,0,25,0
1991716644473195_2614586248852895,6,19,0,25,0.9854
1991716644473195_2614591955518991,2,9,0,11,1.3104
1991716644473195_2614599028851617,1,24,0,25,0.7269
1991716644473195_2614619175516269,0,4,0,4,0
1991716644473195_2614621058849414,1,24,0,25,0.4215
1991716644473195_2614655738845946,6,19,0,25,1.1157
1991716644473195_2614661758845344,2,23,0,25,1.2223
1991716644473195_2614663018845218,0,24,1,25,-0.25
1991716644473195_2614665162178337,19,6,0,25,10.5244
1991716644473195_2614676815510505,3,22,0,25,1.432
1991716644473195_2614702852174568,6,15,0,21,2.4273
1991716644473195_2614706642174189,1,24,0,25,0.4404
1991716644473195_2614725992172254,0,25,0,25,0
1991716644473195_2614744545503732,1,24,0,25,0.4215
1991716644473195_2614760205502166,6,19,0,25,0.8264
1991716644473195_2614771308834389,2,23,0,25,0.9521
1991716644473195_2614772128834307,0,25,0,25,0
1991716644473195_2615227722122081,0,24,1,25,-0.25
1991716644473195_2615393395438847,1,24,0,25,0.7297
1991716644473195_2615425882102265,1,24,0,25,0.4404
1991716644473195_2615435038768016,5,20,0,25,2.3796
1991716644473195_2615439598767560,6,17,2,25,2.8448
1991716644473195_2615453812099472,1,24,0,25,0.4404
1991716644473195_2615485488762971,3,0,0,3,1.3723
1991716644473195_2615492322095621,0,25,0,25,0
1991716644473195_2615518625426324,0,25,0,25,0
1991716644473195_2615553428756177,1,24,0,25,0.4404
1991716644473195_2615558838755636,1,24,0,25,0.4048
1991716644473195_2615595772085276,4,21,0,25,2.0481
1991716644473195_2615672162077637,1,24,0,25,0.4404
1991716644473195_2615716002073253,2,23,0,25,0.8808
1991716644473195_2615750975403089,1,23,1,25,-0.1251
1991716644473195_2615980885380098,2,23,0,25,0.9158
1991716644473195_2616027778708742,2,23,0,25,1.272
1991716644473195_2616053072039546,1,24,0,25,0.6249
1991716644473195_2616115465366640,5,20,0,25,2.2695
1991716644473195_2616131438698376,3,22,0,25,1.3212
1991716644473195_2616168068694713,1,24,0,25,0.4404
1991716644473195_2616172308694289,1,23,1,25,-0.0863
1991716644473195_2616174305360756,2,23,0,25,0.8808
1991716644473195_2616255128686007,1,0,0,1,0.6249
1991716644473195_2616300795348107,0,25,0,25,0
1991716644473195_2616301942014659,0,17,0,17,0
1991716644473195_2616313472013506,2,23,0,25,1.3546
1991716644473195_2616334495344737,2,23,0,25,1.3388
1991716644473195_2616341218677398,1,23,1,25,0.1736
1991716644473195_2616354288676091,0,25,0,25,0
1991716644473195_2616356052009248,0,23,2,25,-1.0534
1991716644473195_2616428975335289,1,24,0,25,0.9173
1991716644473195_2616460271998826,0,25,0,25,0
1991716644473195_2616474628664057,0,22,0,22,0
1991716644473195_2616485678662952,0,24,1,25,-0.5267
1991716644473195_2616501631994690,0,25,0,25,0
1991716644473195_2616517661993087,4,21,0,25,2.1538
1991716644473195_2616527725325414,0,25,0,25,0
1991716644473195_2616575391987314,1,24,0,25,0.7297
1991716644473195_2616600775318109,2,23,0,25,1.3577
1991716644473195_2616610625317124,1,23,1,25,0.3549
1991716644473195_2616647981980055,0,25,0,25,0
1991716644473195_2616878748623645,0,8,0,8,0
1991716644473195_2616945455283641,2,23,0,25,1.1175
1991716644473195_2616946911950162,1,24,0,25,0.7297
1991716644473195_2616972575280929,0,14,0,14,0
1991716644473195_2616999995278187,0,25,0,25,0
1991716644473195_2617039038607616,0,25,0,25,0
1991716644473195_2617040201940833,1,24,0,25,0.4404
1991716644473195_2617076378603882,0,24,1,25,-0.5267
1991716644473195_2617107741934079,0,25,0,25,0
1991716644473195_2617113838600136,0,25,0,25,0
1991716644473195_2617119691932884,1,24,0,25,0.9378
1991716644473195_2617130115265175,0,25,0,25,0
1991716644473195_2617139225264264,0,24,1,25,-0.5267
1991716644473195_2617148891929964,6,17,2,25,1.7109
1991716644473195_2617295045248682,5,20,0,25,2.3406
1991716644473195_2617323945245792,2,23,0,25,0.933
1991716644473195_2617400301904823,2,23,0,25,0.9331
1991716644473195_2617446721900181,1,24,0,25,0.4404
1991716644473195_2617799665198220,1,7,0,8,0.6478
1991716644473195_2617800181864835,0,11,0,11,0
1991716644473195_2617807271864126,0,25,0,25,0
1991716644473195_2617873371857516,1,24,0,25,0.3612
1991716644473195_2617899855188201,0,9,0,9,0
1991716644473195_2617930925185094,4,18,0,22,2.1491
1991716644473195_2617952115182975,0,25,0,25,0
1991716644473195_2617958908515629,1,10,0,11,0.4927
1991716644473195_2618004861844367,0,25,0,25,0
1991716644473195_2618091268502393,0,2,1,3,-0.296
1991716644473195_2618115931833260,2,23,0,25,1.3074
1991716644473195_2618314218480098,0,5,0,5,0
1991716644473195_2618320945146092,1,12,0,13,0.4404
1991716644473195_2618339858477534,1,24,0,25,0.4404
1991716644473195_2618652225112964,0,25,0,25,0
1991716644473195_2618743898437130,0,25,0,25,0
1991716644473195_2618794705098716,0,25,0,25,0
1991716644473195_2618798931764960,1,24,0,25,0.7579
1991716644473195_2618855381759315,1,24,0,25,0.6249
1991716644473195_2618871911757662,1,14,0,15,0.4404
1991716644473195_2618888838422636,0,25,0,25,0
1991716644473195_2618922031752650,0,25,0,25,0
1991716644473195_2618943695083817,0,3,0,3,0
1991716644473195_2618944638417056,1,24,0,25,0.4215
1991716644473195_2619130821731771,4,21,0,25,2.2181
1991716644473195_2619135158398004,1,24,0,25,0.6249
1991716644473195_2619397188371801,0,18,2,20,-0.2054
1991716644473195_2619515498359970,0,25,0,25,0
1991716644473195_2619529291691924,0,25,0,25,0
1991716644473195_2619611708350349,1,23,1,25,0.2436
1991716644473195_2619615778349942,5,20,0,25,2.6878
1991716644473195_2619640268347493,1,6,0,7,0.6486
1991716644473195_2619662515011935,21,4,0,25,11.8174
1991716644473195_2619685551676298,3,1,0,4,1.242
1991716644473195_2619775098334010,0,7,0,7,0
1991716644473195_2619856961659157,1,13,0,14,0.5719
1991716644473195_2619899244988262,2,23,0,25,1.0653
1991716644473195_2619991458312374,1,24,0,25,0.4404
1991716644473195_2620101144968072,0,25,0,25,0
1991716644473195_2620259404952246,1,24,0,25,0.5267
1991716644473195_2620428254935361,11,14,0,25,5.5001
1991716644473195_2620428354935351,0,25,0,25,0
1991716644473195_2620432208268299,4,5,0,9,2.1773
1991716644473195_2620438078267712,0,25,0,25,0
1991716644473195_2620524198259100,0,3,0,3,0
1991716644473195_2620554594922727,0,5,0,5,0
1991716644473195_2620586124919574,1,12,0,13,0.4215
1991716644473195_2620599434918243,2,0,0,2,0.6496
1991716644473195_2620605388250981,1,24,0,25,0.4754
1991716644473195_2620738964904290,1,24,0,25,0.4215
1991716644473195_2620754138236106,0,19,0,19,0
1991716644473195_2620755544902632,2,22,1,25,0.4583
1991716644473195_2620769101567943,0,4,0,4,0
1991716644473195_2620795114898675,0,24,1,25,-0.296
1991716644473195_2620821158229404,5,15,5,25,2.9955
1991716644473195_2620824281562425,0,25,0,25,0
1991716644473195_2620867474891439,1,24,0,25,0.4215
1991716644473195_2620906611554192,0,24,1,25,-0.6901
1991716644473195_2620910464887140,0,25,0,25,0
1991716644473195_2621186374859549,0,8,0,8,0
1991716644473195_2621217058189814,0,25,0,25,0
1991716644473195_2621236388187881,1,24,0,25,0.4404
1991716644473195_2621239151520938,2,3,0,5,0.962
1991716644473195_2621287754849411,18,6,1,25,8.8596
1991716644473195_2621316064846580,0,12,5,17,-1.7
1991716644473195_2621370164841170,5,13,7,25,0.1746
1991716644473195_2621374591507394,6,12,7,25,0.8304
1991716644473195_2621398444838342,3,17,5,25,-0.423
1991716644473195_2621401468171373,1,0,1,2,-0.0682
1991716644473195_2621418538169666,0,11,0,11,0
1991716644473195_2621422608169259,1,14,2,17,-0.9278
1991716644473195_2621443838167136,1,0,0,1,0.7408
1991716644473195_2621445881500265,1,0,0,1,0.25
1991716644473195_2621452088166311,0,14,0,14,0
1991716644473195_2621585084819678,0,2,0,2,0
1991716644473195_2621707348140785,1,8,0,9,0.5216
1991716644473195_2621745364803650,3,2,16,21,-3.3225
1991716644473195_2621784918133028,5,8,5,18,1.6966
1991716644473195_2621845868126933,2,13,0,15,0.8619
1991716644473195_2622064428105077,0,7,0,7,0
1991716644473195_2622112364766950,1,3,0,4,0.4404
1991716644473195_2622161221428731,1,7,0,8,0.4215
1991716644473195_2622169664761220,3,0,0,3,1.5513
1991716644473195_2622192911425562,3,15,1,19,1.1698
1991716644473195_2622200588091461,4,12,0,16,1.8127
1991716644473195_2622221894755997,2,14,0,16,0.8619
1991716644473195_2622225808088939,1,9,0,10,0.7205
1991716644473195_2622244788087041,2,0,0,2,0.8969
1991716644473195_2622254464752740,9,15,1,25,4.0747
1991716644473195_2622273391417514,1,0,0,1,0.6361
1991716644473195_2622375458073974,0,0,1,1,-0.34
1991716644473195_2622409108070609,7,11,0,18,4.0752
1991716644473195_2622414681403385,9,15,1,25,2.4428
1991716644473195_2622424564735730,2,0,0,2,0.962
1991716644473195_2622457028065817,4,4,1,9,1.2241
1991716644473195_2622463764731810,10,14,1,25,4.1876
1991716644473195_2622465234731663,0,2,0,2,0
1991716644473195_2622489674729219,1,0,0,1,0.5216
1991716644473195_2622497431395110,2,0,0,2,0.962
1991716644473195_2622546908056829,6,0,0,6,3.0039
1991716644473195_2622658524712334,2,2,0,4,0.8808
1991716644473195_2622685584709628,18,7,0,25,9.9534
1991716644473195_2622979151346938,2,1,0,3,0.962
1991716644473195_2622980428013477,3,1,0,4,1.6859
1991716644473195_2622989718012548,6,1,0,7,2.8892
1991716644473195_2623053868006133,6,14,0,20,2.9893
1991716644473195_2623084701336383,6,0,1,7,2.8309
1991716644473195_2623125927998927,3,0,22,25,-3.8319
1991716644473195_2623136684664518,2,23,0,25,0.5
1991716644473195_2623145357996984,2,9,0,11,1.1175
1991716644473195_2623177044660482,4,0,0,4,1.7581
1991716644473195_2623184177993102,12,3,1,16,5.4075
1991716644473195_2623269084651278,4,6,0,10,1.7761
1991716644473195_2623331357978384,1,0,0,1,0.4404
1991716644473195_2623908011254052,2,2,0,4,0.9158
1991716644473195_2623924404585746,5,0,0,5,3.0889
1991716644473195_2623953037916216,0,2,0,2,0
1991716644473195_2623973797914140,1,0,0,1,0.4215
1991716644473195_2624018327909687,4,8,0,12,1.7588
1991716644473195_2624076341237219,4,0,0,4,2.0141
1991716644473195_2624262384551948,1,0,0,1,0.4404
1991716644473195_2624333997878120,19,4,0,23,9.739
1991716644473195_2624345471210306,12,8,0,20,7.2569
1991716644473195_2624380281206825,15,8,2,25,6.8342
1991716644473195_2624708711173982,2,1,0,3,0.8808
1991716644473195_2624774127834107,8,0,0,8,4.3428
1991716644473195_2624814567830063,4,1,0,5,2.2703
1991716644473195_2624871441157709,1,0,0,1,0.6486
1991716644473195_2624907411154112,7,18,0,25,2.8589
1991716644473195_2624947201150133,4,1,0,5,1.7652
1991716644473195_2624947371150116,5,10,5,20,0.7574
1991716644473195_2624959784482208,12,13,0,25,3.4456
1991716644473195_2625166507794869,13,11,1,25,5.5555
1991716644473195_2625231414455045,0,20,5,25,-0.9953
1991716644473195_2625538051091048,2,1,1,4,-0.1495
1991716644473195_2625612124416974,14,7,4,25,5.3415
1991716644473195_2625624857749034,1,0,0,1,0.25
1991716644473195_2625637891081064,1,3,0,4,0.3818
1991716644473195_2625652367746283,12,13,0,25,7.2018
1991716644473195_2625654657746054,1,1,0,2,0.6361
1991716644473195_2625725724405614,1,7,0,8,0.25
1991716644473195_2625827604395426,0,3,0,3,0
1991716644473195_2625858034392383,1,24,0,25,0.25
1991716644473195_2625861084392078,9,2,2,13,3.8885
1991716644473195_2625862344391952,1,0,0,1,0.6249
1991716644473195_2625865667724953,2,1,0,3,1.0021
1991716644473195_2625895364388650,1,6,0,7,0.4404
1991716644473195_2625896654388521,0,13,0,13,0
1991716644473195_2626011021043751,1,0,0,1,0.4754
1991716644473195_2626096211035232,1,1,0,2,0.25
1991716644473195_2626115887699931,7,2,0,9,4.4765
1991716644473195_2626523914325795,0,5,0,5,0
1991716644473195_2626540914324095,5,1,0,6,2.6718
1991716644473195_2626540984324088,3,7,0,10,1.5953
1991716644473195_2626545470990306,2,1,0,3,0.9158
1991716644473195_2626546874323499,5,4,0,9,2.8126
1991716644473195_2626567570988096,0,0,1,1,-0.2263
1991716644473195_2626573277654192,6,0,1,7,2.6814
1991716644473195_2626618464316340,6,3,1,10,2.23
1991716644473195_2626671844311002,8,3,0,11,3.4613
1991716644473195_2626754524302734,2,0,0,2,1.0464
1991716644473195_2626935264284660,12,0,0,12,5.7683
1991716644473195_2626959350948918,19,6,0,25,10.9874
1991716644473195_2627407990904054,0,3,0,3,0
1991716644473195_2627467520898101,22,3,0,25,10.3749
1991716644473195_2627470244231162,2,0,0,2,0.7254
1991716644473195_2627493137562206,5,0,0,5,2.8071
1991716644473195_2627537360891117,2,0,0,2,0.8808
1991716644473195_2627560507555469,1,0,0,1,0.4754
1991716644473195_2627574744220712,6,0,0,6,3.1819
1991716644473195_2627597577551762,2,2,1,5,0.8292
1991716644473195_2627649064213280,9,1,0,10,3.7793
1991716644473195_2627734890871364,0,1,0,1,0
1991716644473195_2627759080868945,1,0,0,1,0.4404
1991716644473195_2627825347528985,4,0,0,4,1.9367
1991716644473195_2627843767527143,4,1,0,5,1.4507
1991716644473195_2627846584193528,1,0,0,1,0.7791
1991716644473195_2627848647526655,3,0,0,3,1.7556
1991716644473195_2627890110855842,5,1,0,6,2.2354
1991716644473195_2628275854150601,4,0,0,4,2.1738
1991716644473195_2628314210813432,6,1,0,7,3.056
1991716644473195_2628350507476469,1,0,1,2,0.7325
1991716644473195_2628385050806348,23,1,1,25,11.5477
1991716644473195_2628441170800736,7,0,0,7,3.3888
1991716644473195_2628578747453645,5,2,0,7,1.7382
1991716644473195_2628581734120013,24,1,0,25,11.4033
1991716644473195_2628760074102179,5,2,0,7,2.124
1991716644473195_2628798754098311,2,0,0,2,1.4995
1991716644473195_2629188950725958,11,1,0,12,5.4434
1991716644473195_2629228190722034,1,1,0,2,0.4404
1991716644473195_2629254060719447,3,0,1,4,1.1975
1991716644473195_2629267054051481,3,1,0,4,1.846
1991716644473195_2629321130712740,14,3,1,18,6.2072
1991716644473195_2629330840711769,6,2,0,8,3.2494
1991716644473195_2629383197373200,20,2,0,22,9.5846
1991716644473195_2629393127372207,18,7,0,25,9.0665
1991716644473195_2629393974038789,6,0,0,6,2.8786
1991716644473195_2629395844038602,6,3,0,9,2.9035
1991716644473195_2629400564038130,1,2,0,3,0.2732
1991716644473195_2629470494031137,2,0,0,2,0.8808
1991716644473195_2629477460697107,6,1,0,7,2.0047
1991716644473195_2629490740695779,0,1,0,1,0
1991716644473195_2629502244027962,0,2,0,2,0
1991716644473195_2629615944016592,1,0,0,1,0.8313
1991716644473195_2629746534003533,2,0,0,2,0.8808
1991716644473195_2629877787323741,21,4,0,25,12.3522
1991716644473195_2630162960628557,1,0,0,1,0.6249
1991716644473195_2630192347292285,1,0,0,1,0.4404
1991716644473195_2630198553958331,1,0,0,1,0.4754
1991716644473195_2630204650624388,1,0,0,1,0.4404
1991716644473195_2630205997290920,2,0,0,2,1.3373
1991716644473195_2630255810619272,1,1,0,2,0.4404
1991716644473195_2630289240615929,0,1,0,1,0
1991716644473195_2630371283941058,1,0,0,1,0.4404
1991716644473195_2630395250605328,2,0,0,2,1.0209
1991716644473195_2630420563936130,2,1,0,3,0.8619
1991716644473195_2630584273919759,1,2,0,3,0.4927
1991716644473195_2630616820583171,18,7,0,25,9.653
1991716644473195_2630625867248933,11,3,0,14,5.1114
1991716644473195_2630643847247135,17,4,1,22,6.7296
1991716644473195_2630662433911943,5,0,0,5,2.8564
1991716644473195_2630960663882120,1,3,0,4,0.4404
1991716644473195_2630991580545695,2,0,0,2,0.8969
1991716644473195_2630996653878521,5,1,0,6,2.5412
1991716644473195_2630997083878478,1,0,0,1,0.5267
1991716644473195_2631046247206895,11,2,0,13,5.5482
1991716644473195_2631065407204979,2,0,0,2,1.0653
1991716644473195_2631086470536206,19,4,0,23,10.3088
1991716644473195_2631109700533883,2,1,0,3,0.8619
1991716644473195_2631132530531600,3,0,0,3,1.3373
1991716644473195_2631137627197757,6,0,0,6,2.7482
1991716644473195_2631139177197602,1,0,0,1,0.0772
1991716644473195_2631174493860737,18,2,0,20,8.3469
1991716644473195_2631184040526449,22,3,0,25,10.9748
1991716644473195_2631186660526187,17,1,0,18,9.7448
1991716644473195_2631234370521416,1,0,0,1,0.4215
1991716644473195_2631242200520633,22,3,0,25,12.5045
1991716644473195_2631361440508709,2,2,0,4,0.9343
1991716644473195_2631483737163146,0,1,0,1,0
1991716644473195_2631837853794401,0,3,0,3,0
1991716644473195_2631903987121121,17,8,0,25,7.7167
1991716644473195_2631908357120684,1,1,0,2,0.34
1991716644473195_2631924127119107,2,0,0,2,1.0653
1991716644473195_2631934650451388,4,6,2,12,0.642
1991716644473195_2631982000446653,11,1,0,12,6.0254
1991716644473195_2631983563779830,16,9,0,25,7.9509
1991716644473195_2632078330437020,19,6,0,25,10.2488
1991716644473195_2632103920434461,7,1,0,8,3.8196
1991716644473195_2632114247100095,5,0,0,5,2.5173
1991716644473195_2632117873766399,8,2,0,10,4.0248
1991716644473195_2632127767098743,0,1,0,1,0
1991716644473195_2632128113765375,11,1,0,12,4.6621
1991716644473195_2632129820431871,23,0,0,23,12.4342
1991716644473195_2632133317098188,4,0,0,4,2.0026
1991716644473195_2632281060416747,5,1,0,6,2.2767
1991716644473195_2632549313723255,0,1,0,1,0
1991716644473195_2632637837047736,16,0,0,16,8.7289
1991716644473195_2632664123711774,3,1,0,4,1.427
1991716644473195_2632709053707281,2,3,0,5,0.9343
1991716644473195_2632717220373131,20,4,1,25,11.2331
1991716644473195_2632739697037550,2,1,0,3,1.0653
1991716644473195_2632752070369646,1,0,0,1,0.6249
1991716644473195_2632752967036223,1,0,0,1,0.4939
1991716644473195_2632761043702082,1,0,0,1,0.4754
1991716644473195_2632770767034443,7,0,0,7,3.4008
1991716644473195_2632783670366486,3,1,0,4,1.4802
1991716644473195_2632797353698451,3,0,0,3,1.3373
1991716644473195_2632962707015249,0,1,0,1,0
1991716644473195_2632963137015206,1,1,0,2,0.6426
1991716644473195_2632975137014006,4,0,0,4,2.3427
1991716644473195_2633107543667432,4,3,0,7,1.7766
1991716644473195_2633435633634623,12,0,0,12,6.2928
1991716644473195_2633460730298780,1,0,0,1,0.4404
1991716644473195_2633530270291826,2,2,0,4,0.9343
1991716644473195_2633543010290552,2,0,0,2,1.0464
1991716644473195_2633555926955927,6,0,0,6,2.6235
1991716644473195_2633572720287581,3,1,0,4,1.4282
1991716644473195_2633588430286010,2,0,0,2,0.8808
1991716644473195_2633603493617837,1,1,0,2,0.4404
1991716644473195_2633618916949628,5,0,0,5,2.237
1991716644473195_2633633310281522,2,2,0,4,1.1588
1991716644473195_2633641383614048,7,1,0,8,3.1709
1991716644473195_2633641796947340,1,0,0,1,0.4215
1991716644473195_2633721470272706,1,0,0,1,0.875
1991716644473195_2633786253599561,6,18,1,25,1.7441
1991716644473195_2633812196930300,1,0,0,1,0.2732
1991716644473195_2633901270254726,6,0,0,6,3.1263
1991716644473195_2634217473556439,3,0,0,3,1.4424
1991716644473195_2634319440212909,0,3,0,3,0
1991716644473195_2634352080209645,22,2,1,25,9.6133
1991716644473195_2634442886867231,5,0,0,5,2.2543
1991716644473195_2634484673529719,5,1,0,6,2.6714
1991716644473195_2634516823526504,6,3,0,9,2.7092
1991716644473195_2634532883524898,12,1,0,13,6.3981
1991716644473195_2634543853523801,14,0,0,14,8.7452
1991716644473195_2634551560189697,3,0,0,3,1.3735
1991716644473195_2634573113520875,1,0,0,1,0.9232
1991716644473195_2634629126848607,9,0,0,9,4.5945
1991716644473195_2635132950131558,5,0,0,5,2.5593
1991716644473195_2635168790127974,1,0,0,1,0.4404
1991716644473195_2635186823459504,1,0,0,1,0.5222
1991716644473195_2635194156792104,4,0,0,4,1.7238
1991716644473195_2635272263450960,12,1,0,13,6.9904
1991716644473195_2635272780117575,1,0,0,1,0.6249
1991716644473195_2635318573446329,1,3,1,5,0.4942
1991716644473195_2635402606771259,1,0,0,1,0.4404
1991716644473195_2635472456764274,1,0,0,1,0.8957
1991716644473195_2635499513428235,1,0,0,1,0.4404
1991716644473195_2635622833415903,2,0,0,2,1.2363
1991716644473195_2635672570077596,1,0,0,1,0.4215
1991716644473195_2636118530033000,2,0,0,2,0.9174
1991716644473195_2636210546690465,4,0,0,4,1.9606
1991716644473195_2636377016673818,1,0,0,1,0.4404
1991716644473195_2636410266670493,3,1,0,4,1.3184
1991716644473195_2636770259967827,2,0,0,2,1.3361
1991716644473195_2636787413299445,1,0,0,1,0.9474
1991716644473195_2636813833296803,0,1,0,1,0
1991716644473195_2636986749946178,2,2,0,4,0.9331
1991716644473195_2637001416611378,5,0,0,5,3.0631
1991716644473195_2637066479938205,4,0,0,4,1.9043
1991716644473195_2637341483244038,1,0,0,1,0.4927
1991716644473195_2637697409875112,2,1,0,3,0.9861
1991716644473195_2637832299861623,3,0,0,3,1.3007
1991716644473195_2638543059790547,1,0,0,1,0.9686
1991716644473195_2638560689788784,5,2,0,7,2.2531
1991716644473195_2638639616447558,1,0,1,2,0.1444
1991716644473195_2638722356439284,3,1,0,4,1.4688
1991716644473195_2638739776437542,1,1,0,2,0.4215
1991716644473195_2638785466432973,1,0,0,1,0.5859
1991716644473195_2638856303092556,2,0,0,2,0.9729
1991716644473195_2638859493092237,0,3,0,3,0
1991716644473195_2639010403077146,6,1,0,7,2.5086
1991716644473195_2639046599740193,1,0,0,1,0.4215
1991716644473195_2639402133037973,3,0,0,3,1.4614
1991716644473195_2639422296369290,2,4,0,6,1.3737
1991716644473195_2639499186361601,12,9,0,21,5.9238
1991716644473195_2639537863024400,2,0,0,2,0.8016
1991716644473195_2639545449690308,1,0,0,1,0.9545
1991716644473195_2639599663018220,6,0,0,6,3.091
1991716644473195_2639664019678451,13,2,1,16,6.6254
1991716644473195_2639675523010634,2,0,0,2,1.0398
1991716644473195_2639678953010291,6,0,0,6,2.9544
1991716644473195_2639728933005293,2,1,0,3,1.1211
1991716644473195_2639913772986809,4,1,0,5,1.8709
1991716644473195_2640491769595676,6,11,2,19,1.7307
1991716644473195_2640515426259977,4,1,0,5,2.7716
1991716644473195_2642418739402979,1,0,0,1,0.4215
1991716644473195_2642613812716805,2,0,0,2,1.284
1991716644473195_2642901826021337,1,3,0,4,0.4767
1991716644473195_2642941016017418,1,0,0,1,0.9106
1991716644473195_2642976206013899,5,1,0,6,2.8455
1991716644473195_2642994859345367,3,0,0,3,1.3023
1991716644473195_2643122759332577,9,2,0,11,5.0929
1991716644473195_2643163012661885,12,0,0,12,5.5106
1991716644473195_2643252875986232,1,0,0,1,0.4404
1991716644473195_2643254369319416,0,1,0,1,0
1991716644473195_2643495732628613,12,11,2,25,4.3056
1991716644473195_2643947742583412,6,1,0,7,3.3849
1991716644473195_2643953152582871,12,1,0,13,7.1143
1991716644473195_2644009569243896,0,1,0,1,0
1991716644473195_2644032065908313,4,0,0,4,1.9272
1991716644473195_2644125172565669,0,1,0,1,0
1991716644473195_2644145422563644,17,5,0,22,7.0872
1991716644473195_2644198302558356,1,2,0,3,0.4404
1991716644473195_2644217695889750,1,0,0,1,0.9197
1991716644473195_2644425939202259,10,2,0,12,5.0576
1991716644473195_2644469072531279,3,3,0,6,0.9557
1991716644473195_2644498829194970,6,0,0,6,3.3528
1991716644473195_2644937822484404,6,2,0,8,2.7636
1991716644473195_2645200162458170,1,0,0,1,0.4754
1991716644473195_2645201525791367,0,1,0,1,0
1991716644473195_2645709809073872,1,1,0,2,0.8957
1991716644473195_2645801325731387,6,5,0,11,2.6046
1991716644473195_2645814419063411,9,13,1,23,3.8071
1991716644473195_2645917282386458,4,2,0,6,1.9461
1991716644473195_2645923202385866,10,5,2,17,4.511
1991716644473195_2646035389041314,1,1,0,2,0.8799
1991716644473195_2646049275706592,1,1,0,2,0.4404
1991716644473195_2646190525692467,2,0,0,2,1.0398
1991716644473195_2646206332357553,2,2,0,4,1.0398
1991716644473195_2646218255689694,20,4,0,24,12.8572
1991716644473195_2646249875686532,5,1,0,6,2.5294
1991716644473195_2646274052350781,6,0,0,6,2.6235
1991716644473195_2646308109014042,5,3,0,8,3.5116
1991716644473195_2646319869012866,3,2,0,5,1.3912
1991716644473195_2646649658979887,1,0,0,1,0.4215
1991716644473195_2646841742294012,3,2,0,5,1.4613
1991716644473195_2646873452290841,4,0,0,4,1.8139
1991716644473195_2646908462287340,2,1,0,3,1.0528
1991716644473195_2646910902287096,2,0,0,2,1.6254
1991716644473195_2646984195613100,13,5,1,19,7.3182
1991716644473195_2647074182270768,0,1,0,1,0
1991716644473195_2647152572262929,22,3,0,25,12.8555
1991716644473195_2647215218923331,7,2,0,9,3.5652
1991716644473195_2647467495564770,1,0,0,1,0.4754
1991716644473195_2647596662218520,1,0,0,1,0.4404
1991716644473195_2647637478881105,2,0,0,2,0.9331
1991716644473195_2647638175547702,3,1,0,4,1.7982
1991716644473195_2647638362214350,5,0,0,5,2.9541
1991716644473195_2647709722207214,0,1,0,1,0
1991716644473195_2647731572205029,1,0,0,1,0.4404
1991716644473195_2647736395537880,2,0,0,2,0.9142
1991716644473195_2647743582203828,8,2,0,10,4.8741
1991716644473195_2647755908869262,16,7,0,23,8.0794
1991716644473195_2647859092192277,2,1,0,3,0.9158
1991716644473195_2648035095508010,22,3,0,25,12.8231
1991716644473195_2648049598839893,1,1,0,2,0.4754
1991716644473195_2648118015499718,0,1,0,1,0
1991716644473195_2648134765498043,16,5,0,21,7.4051
1991716644473195_2648138585497661,0,1,0,1,0
1991716644473195_2648147428830110,2,2,0,4,1.0398
1991716644473195_2648542152123971,1,1,0,2,0.5994
1991716644473195_2648601268784726,3,0,0,3,1.7982
1991716644473195_2648601802118006,1,0,0,1,0.4215
1991716644473195_2648607528784100,4,0,0,4,1.7421
1991716644473195_2648970458747807,9,1,0,10,4.6959
1991716644473195_2649049452073241,9,1,0,10,4.595
1991716644473195_2649070092071177,6,12,0,18,3.3774
1991716644473195_2649551898689663,1,0,0,1,0.4927
1991716644473195_2649564865355033,1,0,0,1,0.5994
1991716644473195_2649765585334961,1,0,0,1,0.5994
1991716644473195_2649834428661410,13,12,0,25,6.4755
1991716644473195_2649883595323160,18,4,0,22,8.5649
1991716644473195_2649893878655465,18,6,1,25,9.5199
1991716644473195_2650391991938987,6,1,0,7,2.1933
1991716644473195_2650411391937047,6,2,1,9,1.9688
1991716644473195_2650445668600286,1,0,0,1,0.8658
1991716644473195_2650632381914948,12,3,1,16,5.185
1991716644473195_2650650465246473,3,0,0,3,1.7895
1991716644473195_2650946088550244,2,0,0,2,1.1524
1991716644473195_2651104111867775,0,1,0,1,0
1991716644473195_2651667291811457,1,0,0,1,0.4754
1991716644473195_2651687768476076,18,0,0,18,8.8334
1991716644473195_2652000255111494,1,0,0,1,0.4404
1991716644473195_2652213475090172,1,5,0,6,0.5106
1991716644473195_2652309038413949,16,2,0,18,7.8643
1991716644473195_2652380138406839,10,15,0,25,3.5107
1991716644473195_2652382725073247,10,15,0,25,4.1702
1991716644473195_2652412865070233,3,0,0,3,1.3373
1991716644473195_2652461561732030,8,12,0,20,4.8426
1991716644473195_2652482331729953,2,22,0,24,1.0613
1991716644473195_2652497431728443,7,2,0,9,4.8866
1991716644473195_2652583115053208,4,4,0,8,2.1933
1991716644473195_2652849045026615,1,1,0,2,0.4404
1991716644473195_2653009698343883,0,25,0,25,0
1991716644473195_2653033505008169,0,4,0,4,0
1991716644473195_2653092325002287,6,5,1,12,2.3502
1991716644473195_2653101695001350,0,2,0,2,0
1991716644473195_2653155474995972,9,16,0,25,5.1361
1991716644473195_2653214228323430,10,15,0,25,5.1531
1991716644473195_2653247321653454,2,2,0,4,1.0209
1991716644473195_2653288178316035,14,11,0,25,7.6503
1991716644473195_2653314771646709,1,8,0,9,0.4215
1991716644473195_2653346994976820,4,1,0,5,1.9016
1991716644473195_2653391094972410,19,4,2,25,9.7051
1991716644473195_2653393504972169,5,3,0,8,2.2688
1991716644473195_2653434098301443,2,6,0,8,1.1176
1991716644473195_2653536588291194,3,6,0,9,1.4437
1991716644473195_2653536791624507,2,5,0,7,1.1701
1991716644473195_2653608098284043,0,25,0,25,0
1991716644473195_2653815524929967,0,4,0,4,0
1991716644473195_2653840518260801,1,0,0,1,0.8957
1991716644473195_2653860468258806,1,3,0,4,0.5106
1991716644473195_2653903714921148,7,7,0,14,3.6618
1991716644473195_2653904671587719,12,13,0,25,6.925
1991716644473195_2653912634920256,7,14,0,21,2.9964
1991716644473195_2653961068248746,2,4,0,6,1.574
1991716644473195_2653990148245838,2,0,0,2,0.7141
1991716644473195_2654025031575683,3,0,0,3,1.5433
1991716644473195_2654037061574480,3,10,0,13,1.2242
1991716644473195_2654070101571176,0,7,0,7,0
1991716644473195_2654087418236111,3,2,0,5,1.4262
1991716644473195_2654090408235812,11,1,0,12,5.7415
1991716644473195_2654155641562622,3,0,0,3,2.1596
1991716644473195_2654164198228433,2,0,1,3,1.4644
1991716644473195_2654172148227638,4,17,0,21,1.7966
1991716644473195_2654230241555162,5,9,0,14,2.7629
1991716644473195_2654310198213833,1,24,0,25,0.7297
1991716644473195_2654464341531752,3,0,0,3,1.3212
1991716644473195_2654756591502527,2,3,0,5,0.9158
1991716644473195_2654802218164631,3,1,0,4,1.4868
1991716644473195_2654825644828955,0,25,0,25,0
1991716644473195_2654862858158567,8,3,0,11,3.775
1991716644473195_2654924964819023,7,9,0,16,3.363
1991716644473195_2654986434812876,12,13,0,25,6.4441
1991716644473195_2655305194781000,0,5,0,5,0
1991716644473195_2655692551408931,1,0,0,1,0.9664
1991716644473195_2655806464730873,5,4,0,9,2.3097
1991716644473195_2655832904728229,2,0,0,2,0.9158
1991716644473195_2655953431382843,5,20,0,25,2.4388
1991716644473195_2655995808045272,1,2,0,3,0.8957
1991716644473195_2656637237981129,0,3,0,3,0
1991716644473195_2656686591309527,3,0,0,3,1.3023
1991716644473195_2656688547975998,0,7,0,7,0
1991716644473195_2656702084641311,1,0,0,1,0.4215
1991716644473195_2656835137961339,2,4,0,6,1.226
1991716644473195_2656906641287522,3,6,0,9,1.3023
1991716644473195_2656961261282060,1,0,0,1,0.4754
1991716644473195_2656963437948509,1,0,0,1,0.4754
1991716644473195_2657048067940046,12,13,0,25,5.9177
1991716644473195_2657090967935756,6,14,1,21,1.9943
1991716644473195_2657107291267457,17,8,0,25,9.8544
1991716644473195_2657133087931544,1,3,0,4,0.8679
1991716644473195_2657133514598168,2,7,0,9,0.9041
1991716644473195_2657169911261195,2,15,0,17,0.8619
1991716644473195_2657579651220221,0,1,0,1,0
1991716644473195_2657707814540738,6,1,0,7,2.7822
1991716644473195_2657753461202840,5,8,1,14,2.2165
1991716644473195_2657802557864597,0,25,0,25,0
1991716644473195_2657936314517888,0,1,0,1,0
1991716644473195_2658086711169515,2,23,0,25,0.8808
1991716644473195_2658362611141925,0,7,0,7,0
1991716644473195_2658439891134197,4,11,0,15,2.2967
1991716644473195_2658574754454044,13,2,0,15,6.4427
1991716644473195_2658647594446760,2,5,0,7,0.8808
1991716644473195_2658744297770423,21,4,0,25,11.9829
1991716644473195_2658777954433724,4,4,0,8,1.4991
1991716644473195_2658794801098706,0,1,0,1,0
1991716644473195_2658799484431571,1,0,0,1,0.4215
1991716644473195_2658804071097779,23,2,0,25,11.9233
1991716644473195_2658897337755119,17,3,0,20,8.6078
1991716644473195_2658920567752796,2,2,0,4,1.191
1991716644473195_2659044804407039,1,0,0,1,0.4215
1991716644473195_2659281427716710,4,1,0,5,1.7238
1991716644473195_2659468784364641,10,15,0,25,3.2517
1991716644473195_2659585724352947,0,1,0,1,0
1991716644473195_2659682211009965,7,0,0,7,4.2333
1991716644473195_2659698944341625,1,0,0,1,0.4215
1991716644473195_2660166094294910,1,0,0,1,0.5859
1991716644473195_2660385237606329,0,25,0,25,0
1991716644473195_2660427994268720,0,1,0,1,0
1991716644473195_2660448984266621,15,10,0,25,6.7179
1991716644473195_2660477094263810,15,8,0,23,7.4733
1991716644473195_2660486354262884,21,4,0,25,10.3444
1991716644473195_2660661267578726,3,5,0,8,1.9638
1991716644473195_2660799604231559,1,0,0,1,0.8698
1991716644473195_2661334920844694,3,1,0,4,1.3735
1991716644473195_2661351647509688,8,0,0,8,4.1041
1991716644473195_2661371714174348,3,0,0,3,1.7246
1991716644473195_2661567704154749,16,9,0,25,7.079
1991716644473195_2661628777481975,14,11,0,25,7.085
1991716644473195_2661680184143501,9,1,0,10,5.1629
1991716644473195_2661954177449435,2,0,0,2,0.8619
1991716644473195_2662036744107845,3,0,0,3,1.3562
1991716644473195_2662220037422849,16,2,0,18,8.3887
1991716644473195_2662357367409116,3,0,0,3,1.7255
1991716644473195_2662563047388548,17,8,0,25,7.6649
1991716644473195_2662635174048002,2,0,0,2,0.9158
1991716644473195_2663024464009073,1,8,0,9,0.6662
1991716644473195_2663026764008843,1,0,0,1,0.4404
1991716644473195_2663029810675205,3,0,0,3,1.4085
1991716644473195_2663035547341298,1,0,0,1,0.4404
1991716644473195_2663038144007705,1,9,0,10,0.4404
1991716644473195_2663167787328074,7,2,0,9,3.9778
1991716644473195_2663170347327818,1,1,0,2,0.4215
1991716644473195_2663187967326056,6,3,0,9,2.6207
1991716644473195_2663188563992663,3,1,0,4,1.4667
1991716644473195_2663194983992021,0,15,0,15,0
1991716644473195_2663197093991810,6,2,0,8,3.1049
1991716644473195_2663386753972844,2,8,0,10,0.8808
1991716644473195_2663410797303773,10,2,0,12,4.4684
1991716644473195_2663615497283303,1,0,0,1,0.4404
1991716644473195_2663750673936452,3,0,0,3,1.5281
1991716644473195_2664124663899053,16,4,0,20,9.7758
1991716644473195_2664320487212804,3,5,0,8,1.9864
1991716644473195_2664365617208291,14,11,0,25,7.1886
1991716644473195_2664490133862506,8,0,0,8,3.7545
1991716644473195_2664490617195791,2,0,0,2,0.8016
1991716644473195_2664499770528209,18,7,0,25,9.1924
1991716644473195_2664601320518054,3,3,0,6,1.5057
1991716644473195_2664612543850265,10,4,0,14,5.4788
1991716644473195_2664852260492960,1,2,0,3,0.4754
1991716644473195_2665128757131977,3,0,0,3,1.3212
1991716644473195_2665233127121540,6,3,0,9,3.0321
1991716644473195_2665239950454191,3,22,0,25,1.4802
1991716644473195_2665392963772223,2,0,0,2,0.8808
1991716644473195_2665855533725966,1,0,0,1,0.4927
1991716644473195_2665857083725811,16,9,0,25,8.8477
1991716644473195_2665989247045928,1,0,0,1,0.4404
1991716644473195_2666053650372821,1,0,0,1,0.3182
1991716644473195_2666310553680464,2,0,0,2,1.0584
1991716644473195_2666692650308921,3,5,0,8,1.4265
1991716644473195_2666747570303429,1,0,0,1,0.5719
1991716644473195_2666760660302120,9,2,0,11,5.1077
1991716644473195_2666830193628500,1,0,0,1,0.5719
1991716644473195_2666831470295039,13,3,0,16,6.4993
1991716644473195_2666891546955698,0,7,0,7,0
1991716644473195_2666937083617811,1,15,0,16,0.4404
1991716644473195_2666942490283937,0,1,0,1,0
1991716644473195_2667038340274352,2,1,0,3,1.3755
1991716644473195_2667041096940743,12,7,0,19,7.4535
1991716644473195_2667047420273444,2,0,0,2,0.8808
1991716644473195_2667055033606016,5,20,0,25,2.2165
1991716644473195_2667117830266403,1,0,0,1,0.4404
1991716644473195_2667124766932376,4,4,0,8,2.3358
1991716644473195_2667191626925690,1,0,0,1,0.7184
1991716644473195_2667263783585141,1,0,0,1,0.5994
1991716644473195_2667271316917721,3,0,0,3,1.3723
1991716644473195_2667284800249706,0,8,0,8,0
1991716644473195_2667289320249254,1,0,0,1,0.6249
1991716644473195_2667307383580781,6,2,0,8,3.3483
1991716644473195_2667546380223548,3,11,0,14,1.5811
1991716644473195_2667554296889423,3,0,0,3,1.4802
1991716644473195_2667648760213310,20,5,0,25,12.4627
1991716644473195_2667661406878712,1,3,0,4,0.4404
1991716644473195_2667697103541809,2,0,0,2,1.3959
1991716644473195_2667703140207872,1,6,0,7,0.5994
1991716644473195_2667761910201995,10,2,0,12,7.7381
1991716644473195_2667804670197719,2,14,0,16,0.8808
1991716644473195_2667829633528556,0,4,0,4,0
1991716644473195_2667862393525280,1,0,0,1,0.4215
1991716644473195_2667876543523865,5,1,0,6,2.6038
1991716644473195_2667946150183571,4,2,0,6,2.0161
1991716644473195_2667958130182373,0,1,0,1,0
1991716644473195_2668000353511484,20,5,0,25,12.118
1991716644473195_2668635723447947,0,11,0,11,0
1991716644473195_2668655930112593,5,1,0,6,2.7588
1991716644473195_2668714516773401,8,2,0,10,4.1619
1991716644473195_2668755986769254,2,1,0,3,0.8619
1991716644473195_2668775123434007,18,7,0,25,9.4396
1991716644473195_2668819240096262,1,6,0,7,0.34
1991716644473195_2668952053416314,7,1,0,8,3.9634
1991716644473195_2668957620082424,1,7,0,8,0.5994
1991716644473195_2668999360078250,1,1,0,2,0.0772
1991716644473195_2669073860070800,1,0,0,1,0.3612
1991716644473195_2669111323400387,2,0,0,2,0.9158
1991716644473195_2669478033363716,4,0,0,4,2.215
1991716644473195_2669531930024993,2,0,0,2,1.5557
1991716644473195_2669597380018448,16,9,0,25,7.5725
1991716644473195_2669658680012318,14,3,0,17,6.6759
1991716644473195_2669666363344883,2,0,0,2,1.0952
1991716644473195_2669750380003148,20,2,0,22,11.7223
1991716644473195_2669770063334513,17,1,0,18,8.6709
1991716644473195_2669813356663517,2,0,0,2,0.8619
1991716644473195_2669873656657487,5,5,0,10,2.3175
1991716644473195_2670074419970744,1,0,0,1,0.5994
1991716644473195_2670286836616169,1,24,0,25,0.4404
1991716644473195_2670292813282238,24,1,0,25,12.8772
1991716644473195_2670761606568692,1,24,0,25,0.4404
1991716644473195_2670941026550750,15,4,0,19,8.0284
1991716644473195_2671300409848145,11,5,0,16,6.1323
1991716644473195_2671367676508085,2,1,0,3,0.7586
1991716644473195_2671414753170044,6,0,0,6,2.7825
1991716644473195_2671433363168183,1,0,0,1,0.4404
1991716644473195_2671444409833745,23,2,0,25,12.0784
1991716644473195_2671460746498778,5,8,0,13,3.4925
1991716644473195_2671572739820912,1,0,0,1,0.3595
1991716644473195_2671732689804917,2,1,0,3,0.8969
1991716644473195_2672114303100089,9,0,0,9,4.4395
1991716644473195_2672283069749879,2,0,0,2,1.0933
1991716644473195_2672309429747243,2,1,0,3,0.8808
1991716644473195_2672502449727941,19,5,1,25,9.0749
1991716644473195_2672526126392240,22,3,0,25,12.1863
1991716644473195_2672646586380194,6,0,0,6,3.0211
1991716644473195_2673041109674075,5,4,0,9,2.873
1991716644473195_2673245539653632,8,3,0,11,5.1581
1991716644473195_2673278389650347,1,0,0,1,0.5994
1991716644473195_2673291689649017,13,12,0,25,6.953
1991716644473195_2673341659644020,6,14,1,21,3.4635
1991716644473195_2673487489629437,19,6,0,25,9.3149
1991716644473195_2673553842956135,1,0,0,1,0.4404
1991716644473195_2673863662925153,20,5,0,25,10.1061
1991716644473195_2673899749588211,1,1,1,3,0.1444
1991716644473195_2673922629585923,1,0,0,1,0.5994
1991716644473195_2674067672904752,0,16,0,16,0
1991716644473195_2674098509568335,5,2,0,7,2.8149
1991716644473195_2674176216227231,4,0,0,4,1.8225
1991716644473195_2674228126222040,3,0,0,3,1.5057
1991716644473195_2674239366220916,19,3,0,22,9.3836
1991716644473195_2674407316204121,2,1,0,3,0.8808
1991716644473195_2674868469491339,2,0,0,2,0.8619
1991716644473195_2674884692823050,1,0,0,1,0.4404
1991716644473195_2674921999485986,7,1,0,8,3.1306
1991716644473195_2674933129484873,1,1,0,2,0.4404
1991716644473195_2675095532801966,1,0,0,1,0.4404
1991716644473195_2675137116131141,11,3,0,14,5.6273
1991716644473195_2675246262786893,2,0,0,2,1.0748
1991716644473195_2675250202786499,3,0,0,3,1.3212
1991716644473195_2675808199397366,15,9,0,24,9.1419
1991716644473195_2675873809390805,5,0,0,5,2.0972
1991716644473195_2675877056057147,18,4,0,22,8.879
1991716644473195_2675911222720397,1,0,0,1,0.4215
1991716644473195_2675990496045803,0,1,0,1,0
1991716644473195_2675998832711636,8,8,0,16,3.8566
1991716644473195_2676002329377953,6,6,0,12,3.228
1991716644473195_2676011722710347,1,0,0,1,0.5994
1991716644473195_2676055539372632,1,3,0,4,0.296
1991716644473195_2676057876039065,1,0,0,1,0.4215
1991716644473195_2676605302650989,0,1,0,1,0
1991716644473195_2676769375967915,1,2,0,3,0.4404
1991716644473195_2676818625962990,5,0,0,5,2.5789
1991716644473195_2676986445946208,4,1,0,5,2.7253
1991716644473195_2677022799275906,7,10,0,17,3.8612
1991716644473195_2677040335940819,2,23,0,25,1.1567
1991716644473195_2677041739274012,2,4,0,6,0.8808
1991716644473195_2677503255894527,1,8,0,9,0.4404
1991716644473195_2677574839220702,10,3,0,13,5.5988
1991716644473195_2677707739207412,5,0,0,5,2.5426
1991716644473195_2677710059207180,21,4,0,25,12.5424
1991716644473195_2677711149207071,2,0,0,2,1.2629
1991716644473195_2677757222535797,12,2,0,14,5.5342
1991716644473195_2677868312524688,4,0,0,4,2.3757
1991716644473195_2678008212510698,2,1,0,3,1.2629
1991716644473195_2678556942455825,5,0,0,5,3.7088
1991716644473195_2678640445780808,8,3,0,11,4.188
1991716644473195_2678654822446037,0,1,0,1,0
1991716644473195_2678669272444592,7,1,0,8,3.5172
1991716644473195_2679485752362944,11,12,2,25,4.9756
1991716644473195_2679503852361134,4,3,0,7,2.2664
1991716644473195_2679523382359181,0,1,0,1,0
1991716644473195_2679546095690243,15,10,0,25,6.1705
1991716644473195_2679555299022656,5,3,1,9,2.0007
1991716644473195_2679711285673724,4,0,0,4,1.9083
1991716644473195_2679723049005881,9,4,0,13,4.7325
1991716644473195_2679744975670355,2,0,0,2,1.0653
1991716644473195_2679772892334230,6,7,0,13,3.3469
1991716644473195_2679783888999797,11,4,0,15,5.8899
1991716644473195_2679910185653834,1,1,0,2,0.4215
1991716644473195_2680223378955848,1,0,0,1,0.4404
1991716644473195_2680780832233436,2,1,0,3,1.0209
1991716644473195_2680807928897393,2,0,0,2,0.8808
1991716644473195_2680837152227804,16,6,0,22,7.8247
1991716644473195_2681179915526861,13,3,0,16,6.7821
1991716644473195_2681327645512088,6,1,0,7,2.9856
1991716644473195_2681344298843756,6,2,0,8,2.5265
1991716644473195_2681354355509417,0,1,0,1,0
1991716644473195_2681378425507010,10,4,1,15,4.6218
1991716644473195_2681400355504817,2,0,0,2,1.0123
1991716644473195_2681426122168907,11,2,0,13,5.5526
1991716644473195_2681426468835539,1,0,0,1,0.4404
1991716644473195_2681451958832990,5,0,0,5,2.8113
1991716644473195_2681547742156745,4,2,0,6,2.2248
1991716644473195_2682042122107307,2,0,0,2,1.0123
1991716644473195_2682072945437558,15,6,0,21,7.0816
1991716644473195_2682176072093912,2,1,0,3,1.0653
1991716644473195_2682230665421786,0,2,0,2,0
1991716644473195_2682251815419671,20,5,0,25,12.2716
1991716644473195_2682255178752668,2,0,0,2,0.8969
1991716644473195_2682499895394863,4,0,0,4,1.6985
1991716644473195_2682921965352656,2,0,0,2,0.8619
1991716644473195_2683035222007997,1,1,0,2,0.6249
1991716644473195_2683093758668810,3,1,0,4,1.4149
1991716644473195_2683172115327641,13,5,0,18,6.9671
1991716644473195_2683276951983824,3,0,0,3,1.3747
1991716644473195_2683477038630482,0,1,0,1,0
1991716644473195_2683862928591893,8,3,0,11,3.5085
1991716644473195_2683895688588617,1,0,0,1,0.4927
1991716644473195_2683928488585337,9,1,0,10,4.8337
1991716644473195_2683979495246903,22,3,0,25,11.1031
1991716644473195_2683999708578215,11,1,0,12,5.3992
1991716644473195_2684002411911278,12,5,0,17,6.494
1991716644473195_2684126091898910,15,10,0,25,6.8973
1991716644473195_2684960378482148,2,4,0,6,1.9118
1991716644473195_2685031928474993,8,2,0,10,4.211
1991716644473195_2685073361804183,1,0,0,1,0.9569
1991716644473195_2685170428461143,12,1,0,13,6.4642
1991716644473195_2685247911786728,7,1,0,8,3.1351
1991716644473195_2685558551755664,19,5,1,25,9.2155
1991716644473195_2685977738380412,2,1,0,3,1.3263
1991716644473195_2685990021712517,10,9,1,20,5.7185
1991716644473195_2686090878369098,3,0,0,3,1.3212
1991716644473195_2686133798364806,5,2,0,7,2.329
1991716644473195_2686154605029392,7,8,0,15,3.5664
1991716644473195_2686235811687938,1,0,0,1,0.4404
1991716644473195_2686240541687465,3,3,0,6,1.7031
1991716644473195_2686274208350765,2,0,0,2,0.8619
1991716644473195_2686289601682559,15,6,0,21,7.5044
1991716644473195_2686540398324146,1,6,0,7,0.7506
1991716644473195_2686751154969737,1,0,0,1,0.4404
1991716644473195_2686804391631080,6,0,0,6,3.0782
1991716644473195_2686831618295024,1,0,0,1,0.4404
1991716644473195_2687138501597669,5,8,0,13,1.7223
1991716644473195_2687176598260526,15,2,0,17,7.7251
1991716644473195_2687594828218703,1,2,0,3,0.4404
1991716644473195_2687596338218552,2,2,0,4,0.8808
1991716644473195_2687596411551878,1,0,0,1,0.4754
1991716644473195_2687628001548719,1,0,0,1,0.4404
1991716644473195_2687701294874723,11,6,0,17,5.4625
1991716644473195_2687753588202827,3,0,0,3,1.6627
1991716644473195_2687770831534436,4,0,0,4,1.7238
1991716644473195_2687862041525315,3,1,0,4,1.8709
1991716644473195_2687974254847427,3,0,1,4,1.3115
1991716644473195_2688007498177436,1,0,0,1,0.4404
1991716644473195_2688378238140362,2,1,0,3,1.3691
1991716644473195_2688433891468130,10,1,0,11,5.0312
1991716644473195_2688465041465015,1,1,0,2,0.4404
1991716644473195_2688490994795753,3,0,0,3,1.3863
1991716644473195_2688678161443703,4,1,0,5,1.9206
1991716644473195_2688694491442070,1,0,0,1,0.4404
1991716644473195_2688744178103768,4,1,1,6,1.3931
1991716644473195_2688746678103518,3,0,0,3,1.5315
1991716644473195_2688856948092491,2,0,0,2,0.9331
1991716644473195_2688857188092467,5,0,0,5,2.73
1991716644473195_2688881918089994,1,0,0,1,0.4404
1991716644473195_2689123184732534,0,2,0,2,0
1991716644473195_2689225751388944,2,2,0,4,0.933
1991716644473195_2689241854720667,1,0,0,1,0.4215
1991716644473195_2689274731384046,0,4,0,4,0
1991716644473195_2689376468040539,4,0,0,4,1.795
1991716644473195_2689398328038353,3,0,0,3,1.3184
1991716644473195_2689443694700483,4,1,0,5,2.1586
1991716644473195_2689670084677844,2,23,0,25,0.7483
1991716644473195_2689735848004601,4,0,0,4,1.9286
1991716644473195_2690349627943223,0,10,0,10,0
1991716644473195_2690542787923907,0,23,1,24,-0.0649
1991716644473195_2690599311251588,5,0,0,5,3.0033
1991716644473195_2690631761248343,1,0,0,1,0.4215
1991716644473195_2690665491244970,2,0,0,2,1.1988
1991716644473195_2691056681205851,3,2,0,5,1.3184
1991716644473195_2691284084516444,1,0,0,1,0.4754
1991716644473195_2691552487822937,0,4,0,4,0
1991716644473195_2692058117772374,8,0,0,8,4.0305
1991716644473195_2692093551102164,10,0,0,10,4.6756
1991716644473195_2692168061094713,6,1,0,7,3.8677
1991716644473195_2692182124426640,1,7,0,8,0.4404
1991716644473195_2692322714412581,1,3,0,4,0.2732
1991716644473195_2692408284404024,1,1,0,2,0.4215
1991716644473195_2692437774401075,0,3,0,3,0
1991716644473195_2692473431064176,3,0,0,3,1.4085
1991716644473195_2692573451054174,2,0,0,2,1.0464
1991716644473195_2692578727720313,5,0,0,5,2.4199
1991716644473195_2692588591052660,1,0,0,1,0.4404
1991716644473195_2692840967694089,7,2,0,9,4.1958
1991716644473195_2692875021024017,1,8,0,9,0.5994
1991716644473195_2693084567669729,2,12,0,14,0.8619
1991716644473195_2693111771000342,3,5,0,8,1.4483
1991716644473195_2693274384317414,8,5,0,13,3.5865
1991716644473195_2693342164310636,1,0,0,1,0.4215
1991716644473195_2694021650909354,6,9,0,15,2.6046
1991716644473195_2694097254235127,2,3,0,5,1.1701
1991716644473195_2694252157552970,1,6,0,7,0.34
1991716644473195_2694336384211214,0,25,0,25,0
1991716644473195_2694771777501008,1,0,0,1,0.4754
1991716644473195_2694934824151370,3,0,0,3,1.3023
1991716644473195_2695035104141342,13,1,0,14,6.3129
1991716644473195_2695101414134711,5,2,0,7,3.4991
1991716644473195_2695228974121955,5,0,0,5,2.7045
1991716644473195_2695253874119465,3,0,0,3,1.3735
1991716644473195_2695686964076156,2,0,0,2,1.0921
1991716644473195_2695750814069771,1,1,0,2,0.4404
1991716644473195_2695927957385390,14,4,0,18,9.0923
1991716644473195_2696031980708321,23,2,0,25,11.6527
1991716644473195_2696039654040887,2,0,0,2,0.8808
1991716644473195_2696118310699688,22,3,0,25,10.4351
1991716644473195_2696579023986950,0,1,0,1,0
1991716644473195_2696740097304176,22,3,0,25,12.1226
1991716644473195_2696814860630033,3,1,0,4,1.2943
1991716644473195_2696832073961645,10,2,0,12,5.0365
1991716644473195_2696856913959161,1,2,0,3,0.3869
1991716644473195_2696891010622418,1,0,0,1,0.4404
1991716644473195_2697424593902393,6,1,0,7,2.8014
1991716644473195_2697661823878670,3,1,0,4,1.2834
1991716644473195_2697723953872457,1,0,0,1,0.4754
1991716644473195_2697770553867797,12,0,1,13,5.4397
1991716644473195_2697771333867719,5,0,0,5,2.832
1991716644473195_2697783773866475,3,0,0,3,1.4817
1991716644473195_2698257730485746,13,2,0,15,6.256
1991716644473195_2698278327150353,11,0,0,11,6.3597
1991716644473195_2698474007130785,22,3,0,25,13
1991716644473195_2698574267120759,23,2,0,25,13.709
1991716644473195_2698731950438324,3,1,2,6,0.71
1991716644473195_2698791193765733,1,0,0,1,0.4404
1991716644473195_2699420963702756,4,1,0,5,1.9421
1991716644473195_2699518820359637,22,3,0,25,12.4202
1991716644473195_2699629777015208,4,1,0,5,2.0063
1991716644473195_2699640213680831,3,0,0,3,1.1628
1991716644473195_2700018100309709,3,1,0,4,1.3212
1991716644473195_2700071560304363,1,0,0,1,0.4404
1991716644473195_2700159116962274,2,0,0,2,0.8619
1991716644473195_2700203910291128,6,0,0,6,2.9716
1991716644473195_2700293913615461,2,0,0,2,1.2949
1991716644473195_2700528233592029,7,1,0,8,4.2873
1991716644473195_2700984986879687,5,0,0,5,2.514
1991716644473195_2701102933534559,6,0,0,6,2.9882
1991716644473195_2701287380182781,3,0,0,3,2.0247
1991716644473195_2701291023515750,3,0,0,3,1.3952
1991716644473195_2701302996847886,11,1,1,13,6.046
1991716644473195_2701328763511976,1,0,0,1,0.4404
1991716644473195_2701840063460846,5,0,0,5,2.9714
1991716644473195_2701865696791616,1,0,0,1,0.4404
1991716644473195_2702234136754772,3,1,0,4,1.7732
1991716644473195_2702235620087957,4,3,0,7,2.2
1991716644473195_2702380990073420,20,1,0,21,9.6412
1991716644473195_2702388786739307,9,1,0,10,5.1988
1991716644473195_2702432026734983,1,0,0,1,0.8051
1991716644473195_2702850380026481,1,0,0,1,0.9378
1991716644473195_2702887256689460,5,0,0,5,2.9141
1991716644473195_2702889586689227,1,0,0,1,0.4404
1991716644473195_2702909376687248,5,0,1,6,2.263
1991716644473195_2703344519977067,2,0,0,2,1.0773
1991716644473195_2703389823305870,1,0,0,1,0.4404
1991716644473195_2703391873305665,1,0,0,1,0.4404
1991716644473195_2704063906571795,2,0,0,2,1.6227
1991716644473195_2704346456543540,1,0,0,1,0.4404
1991716644473195_2704726876505498,22,3,0,25,11.1752
1991716644473195_2704891646489021,3,0,0,3,1.9515
1991716644473195_2705056496472536,3,0,0,3,1.4892
1991716644473195_2705066179804901,13,5,0,18,7.5714
1991716644473195_2705094606468725,8,0,0,8,4.4366
1991716644473195_2705790796399106,2,1,0,3,0.9331
1991716644473195_2705897806388405,1,0,0,1,0.8545
1991716644473195_2706146683030184,1,1,2,4,-0.5078
1991716644473195_2707047972940055,2,1,0,3,1.2992
1991716644473195_2707615732883279,12,2,0,14,7.3222
1991716644473195_2707676942877158,5,0,0,5,2.8558
1991716644473195_2707715372873315,3,2,0,5,2.2781
1991716644473195_2707756629535856,1,0,0,1,0.4215
1991716644473195_2707759179535601,1,0,0,1,0.1058
1991716644473195_2707850172859835,5,10,2,17,2.0551
1991716644473195_2707950289516490,0,0,1,1,-0.2263
1991716644473195_2708055582839294,1,0,0,1,0.8439
1991716644473195_2708169936161192,6,2,0,8,2.9133
1991716644473195_2708226732822179,3,0,0,3,1.8535
1991716644473195_2708615412783311,3,0,0,3,1.8799
1991716644473195_2708644446113741,1,0,0,1,0.8439
1991716644473195_2708689646109221,19,6,0,25,9.8141
1991716644473195_2708725712772281,6,4,0,10,2.3098
1991716644473195_2708800959431423,0,1,0,1,0
1991716644473195_2708825439428975,3,1,0,4,1.3659
1991716644473195_2708834989428020,1,0,0,1,0.4215
1991716644473195_2708980192746833,3,0,0,3,1.498
1991716644473195_2709031609408358,0,1,0,1,0
1991716644473195_2709095079402011,3,0,0,3,1.7281
1991716644473195_2709171549394364,4,0,0,4,2.2159
1991716644473195_2709639642680888,1,0,0,1,0.4939
1991716644473195_2709689612675891,4,0,0,4,2.2109
1991716644473195_2709919012652951,7,3,1,11,2.6745
1991716644473195_2710979632546889,3,0,0,3,1.6159
1991716644473195_2711700269141492,16,8,1,25,6.764
1991716644473195_2712034032441449,1,24,0,25,0.8625
1991716644473195_2712036732441179,2,2,0,4,0.4473
1991716644473195_2713490105629175,1,1,0,2,0.6361
1991716644473195_2713526492292203,19,6,0,25,9.9249
1991716644473195_2713787662266086,5,0,0,5,2.9392
1991716644473195_2713873465590839,6,1,0,7,2.6947
1991716644473195_2713927645585421,14,2,0,16,6.784
1991716644473195_2714031955574990,9,3,0,12,4.5621
1991716644473195_2715421285436057,4,5,0,9,2.1409
1991716644473195_2715785882066264,1,0,0,1,0.7506
1991716644473195_2716649665313219,10,4,0,14,6.1237
1991716644473195_2717176375260548,21,4,0,25,12.3565
1991716644473195_2717633701881482,1,0,0,1,0.836
1991716644473195_2717665455211640,6,0,0,6,3.6462
1991716644473195_2718319911812861,1,0,0,1,0.4754
1991716644473195_2718573031787549,1,1,0,2,0.7269
1991716644473195_2720210221623830,1,1,0,2,0.4404
1991716644473195_2720446311600221,2,0,0,2,0.9093
1991716644473195_2721319471512905,9,1,1,11,3.7456
1991716644473195_2721584381486414,1,0,0,1,0.4404
1991716644473195_2722123318099187,2,0,0,2,1.0765
1991716644473195_2722955131349339,1,0,0,1,0.5859
1991716644473195_2723899807921538,17,1,0,18,8.7992
1991716644473195_2723983654579820,1,0,0,1,0.4404
1991716644473195_2726686524309533,24,1,0,25,15.1238
1991716644473195_2727697520875100,23,2,0,25,13.349
1991716644473195_2729660587345460,5,0,0,5,3.1992
1991716644473195_2731768797134639,22,3,0,25,12.1412
1991716644473195_2733661296945389,2,0,0,2,1.5906
1991716644473195_2736787236632795,1,2,0,3,0.4927
1991716644473195_2739384023039783,16,5,1,22,7.1534
1991716644473195_2739630703015115,5,1,0,6,2.5111
1991716644473195_2741623612815824,0,1,0,1,0
1991716644473195_2742034119441440,1,0,0,1,0.4754
1991716644473195_2742176556093863,2,0,0,2,1.0576
1991716644473195_2742473692730816,1,0,0,1,0.5994
1991716644473195_2742893929355459,22,3,0,25,13.5808
1991716644473195_2742967596014759,14,6,0,20,5.9289
1991716644473195_2743745425936976,10,3,1,14,4.5468
1991716644473195_2744638249181027,3,0,0,3,1.5984
1991716644473195_2746383625673156,8,0,0,8,3.675
1991716644473195_2746568532321332,21,4,0,25,10.6513
1991716644473195_2747195372258648,3,0,0,3,1.7975
1991716644473195_2747228562255329,23,2,0,25,12.2153
1991716644473195_2747450078899844,1,0,0,1,0.4404
1991716644473195_2747925685518950,2,1,0,3,1.3949
1991716644473195_2748645028780349,23,2,0,25,16.218
1991716644473195_2748785925432926,7,1,0,8,4.8876
1991716644473195_2748805238764328,23,2,0,25,11.3931
1991716644473195_2749490902029095,1,2,0,3,0.8176
1991716644473195_2749606995350819,21,4,0,25,10.4347
1991716644473195_2749639225347596,4,0,0,4,2.1699
1991716644473195_2749770505334468,20,5,0,25,11.6105
1991716644473195_2752026915108827,1,0,0,1,0.2732
1991716644473195_2752057521772433,0,4,0,4,0
1991716644473195_2753100835001435,5,0,0,5,2.6341
1991716644473195_2753616771616508,2,2,0,4,0.7586
1991716644473195_2753671978277654,5,8,0,13,2.6684
1991716644473195_2756535241324661,10,2,1,13,4.858
1991716644473195_2756645264646992,11,0,0,11,5.541
1991716644473195_2757343467910505,0,7,0,7,0
1991716644473195_2757367171241468,21,4,0,25,11.3753
1991716644473195_2757577674553751,1,0,0,1,0.5994
1991716644473195_2758015914509927,1,0,0,1,0.4404
1991716644473195_2758080501170135,4,0,0,4,1.5502
1991716644473195_2758853354426183,23,2,0,25,12.3958
1991716644473195_2758920867752765,3,0,0,3,1.2063
1991716644473195_2759054561072729,9,1,0,10,4.7078
1991716644473195_2759166597728192,4,0,0,4,2.393
1991716644473195_2759213087723543,1,2,0,3,0.2732
1991716644473195_2759541927690659,7,1,0,8,3.2826
1991716644473195_2759751231003062,0,3,0,3,0
1991716644473195_2760366534274865,1,0,0,1,0.6249
1991716644473195_2760435384267980,6,1,1,8,2.386
1991716644473195_2760437850934400,1,1,0,2,0.3612
1991716644473195_2761217477523104,5,0,0,5,2.8967
1991716644473195_2763225580655627,13,1,0,14,7.6716
1991716644473195_2763338293977689,9,0,0,9,4.8075
1991716644473195_2763797950598390,5,2,0,7,2.1221
1991716644473195_2763877547257097,11,1,0,12,5.1229
1991716644473195_2764073117237540,2,0,0,2,0.9158
1991716644473195_2764116600566525,1,0,0,1,0.3612
1991716644473195_2764132093898309,5,0,0,5,2.6328
1991716644473195_2764312170546968,19,4,2,25,10.8815
1991716644473195_2764331013878417,3,1,0,4,1.3212
1991716644473195_2764630460515139,9,0,0,9,5.1198
1991716644473195_2764819903829528,6,1,0,7,2.8969
1991716644473195_2764934270484758,6,4,0,10,2.6956
1991716644473195_2765714897073362,16,9,0,25,8.0197
1991716644473195_2765872270390958,2,0,0,2,0.7486
1991716644473195_2767006773610841,9,2,0,11,5.288
1991716644473195_2767169463594572,19,4,0,23,9.7383
1991716644473195_2767698690208316,8,2,0,10,3.9404
1991716644473195_2767700086874843,2,0,0,2,1.3459
1991716644473195_2767948900183295,8,4,0,12,4.4423
1991716644473195_2768433816801470,0,2,1,3,-0.3182
1991716644473195_2768627060115479,3,1,0,4,1.7286
1991716644473195_2769073863404132,16,2,1,19,8.7164
1991716644473195_2769145723396946,2,0,0,2,0.8016
1991716644473195_2770152629962922,15,0,0,15,7.5868
1991716644473195_2771818669796318,6,1,0,7,3.0702
1991716644473195_2771842466460605,2,0,0,2,1.4269
1991716644473195_2771874869790698,13,1,1,15,5.2006
1991716644473195_2772202329757952,16,8,1,25,8.4765
1991716644473195_2772247849753400,3,2,0,5,2.1548
1991716644473195_2772291466415705,0,1,0,1,0
1991716644473195_2772344176410434,2,0,1,3,0.2814
1991716644473195_2772955879682597,1,0,1,2,-0.159
1991716644473195_2775357492775769,1,0,0,1,0.8439
1991716644473195_2775640126080839,1,0,0,1,0.4754
1991716644473195_2776800579298127,1,0,0,1,0.4215
1991716644473195_2776899329288252,8,0,1,9,3.6537
1991716644473195_2777954639182721,5,1,0,6,2.7754
1991716644473195_2778717999106385,0,1,0,1,0
1991716644473195_2779705172341001,1,1,1,3,-0.1509
1991716644473195_2781189532192565,1,0,0,1,0.9686
1991716644473195_2781631622148356,18,3,0,21,10.5046
1991716644473195_2781855468792638,1,0,0,1,0.4404
1991716644473195_2782287895416062,21,4,0,25,10.0511
1991716644473195_2783724471939071,7,3,0,10,3.0075
1991716644473195_2784553475189504,3,1,0,4,1.2727
1991716644473195_2784941715150680,0,1,0,1,0
1991716644473195_2785065705138281,12,0,2,14,4.7146
1991716644473195_2785724445072407,18,6,1,25,9.0528
1991716644473195_2785973241714194,2,0,0,2,1.0748
1991716644473195_2786305358347649,9,1,1,11,4.4299
1991716644473195_2786496308328554,20,3,1,24,9.6261
1991716644473195_2786571411654377,1,0,0,1,0.4215
1991716644473195_2786675231643995,1,0,0,1,0.4754
1991716644473195_2786917584953093,2,0,1,3,0.6961
1991716644473195_2787044844940367,2,0,0,2,0.8808
1991716644473195_2787961571515361,14,10,1,25,6.0121
1991716644473195_2788115501499968,2,0,0,2,1.0464
1991716644473195_2788425378135647,1,0,0,1,0.7506
1991716644473195_2788441358134049,2,0,0,2,0.8619
1991716644473195_2788459574798894,19,5,1,25,8.9396
1991716644473195_2788756538102531,1,0,0,1,0.6249
1991716644473195_2788760164768835,2,0,0,2,0.7136
1991716644473195_2789101561401362,3,4,0,7,1.6203
1991716644473195_2789159138062271,4,3,1,8,1.5894
1991716644473195_2789187944726057,6,1,0,7,3.3455
1991716644473195_2789427531368765,1,0,0,1,0.4754
1991716644473195_2790077244637127,3,3,0,6,1.383
1991716644473195_2790099017968283,9,4,2,15,5.2365
1991716644473195_2790241321287386,0,1,0,1,0
1991716644473195_2791183604526491,1,0,0,1,0.4404
1991716644473195_2791405407837644,1,0,0,1,0.8074
1991716644473195_2791417721169746,21,3,1,25,9.2725
1991716644473195_2792458917732293,1,0,0,1,0.4404
1991716644473195_2792462927731892,2,2,0,4,1.3368
1991716644473195_2792857774359074,4,0,1,5,2.1316
1991716644473195_2793422727635912,0,1,0,1,0
1991716644473195_2793493554295496,4,1,0,5,2.3151
1991716644473195_2794081994236652,10,3,0,13,6.052
1991716644473195_2794082240903294,14,0,0,14,8.199
1991716644473195_2794217790889739,19,6,0,25,11.1754
1991716644473195_2794406357537549,13,1,0,14,6.5384
1991716644473195_2794415214203330,2,2,0,4,0.7136
1991716644473195_2794906374154214,3,0,1,4,0.5552
1991716644473195_2795011284143723,2,0,0,2,0.8808
1991716644473195_2795177984127053,2,0,0,2,1.0653
1991716644473195_2795420990769419,1,0,0,1,0.4215
1991716644473195_2795468200764698,4,2,0,6,2.6036
1991716644473195_2796183594026492,18,2,0,20,10.4798
1991716644473195_2799856790325839,2,0,0,2,0.843
1991716644473195_2801394706838714,24,1,0,25,14.1207